Light pierces your vision as your eyes flutter open. Blurred shapes spin around as you shake the sound of a pounding heart free. You remember a struggle, the abduction, your name... nothing.

Third-floor-outside
Deliverance
A Halloween story by Wesley Werner
Release 1 / Serial number 161030 / Inform 7 build 6M62 (I6/v6.33 lib 6/12N) SD

Third-floor-outside

The Girl

>get up
You try to stand up. Your hands and feet are bound to the chair with rope, and you nearly topple over. The chair creaks violently.

The Girl

* * *

Light pierces your vision as your eyes flutter open. Blurred shapes spin around as you shake the sound of a pounding heart free. You remember a struggle, the abduction, your name... nothing.

Third-floor-outside
Deliverance
A Halloween story by Wesley Werner
Release 1 / Serial number 161030 / Inform 7 build 6M62 (I6/v6.33 lib 6/12N) SD

Third-floor-outside

The Girl

>x self
You see dirt on your bruised arms. You are wearing jeans and a t-shirt. Your hands are tied with ropes to the back of the chair, your feet tied to the legs of the chair.

The Girl

* * *

>i
You are carrying:
  some twine
  a bottle of turpentine
  a craft knife

The Girl

>w
(first opening the loft door)

You feel faint.

Bedroom
A small bedroom furnished with a mattress on the floor. A door to the east leads to the loft, another door is due south.

On the mattress are a sheet and a torch.

The Girl

>z
Time passes.

The room turns into a tunnel, the floor rising up to meet you. Shadows creep in from all sides as your vision fades.
----------PAUSE----------
The last daylight creeps away, the moon struggles to find gaps through the looming thunder clouds. A chill moves over your skin.

Front of the house
You are in front of an old three storey house. The flaking paint and shoddy walkway indicate it's age and abandonment. The front door is here, the porch wraps around the building, towards the south. You are carrying your badge, gun and torch.

Otto

* * *

>x gun
A Glock 9mm, standard issue.

Earlier today, an anonymous tip was called in at the homicide office. All they gave was a name, in connection with the missing girl.

Otto

>x flash light
You can't see any such thing.

Otto

* * *

>x torch
A high-powered tactical torch.

The torch is currently switched off.

The name led to outdated property records, and those led to this address. Time is life, and death. I had to get here quick, even if my partner was an hour away the other direction. I had to.

Otto

>z
Time passes.

This place is derelict, remote and dreary. The perfect place to hide. Never have I wanted something so dismal to be so true. I pray she is alive.

Otto

>z
Time passes.

Otto

>z
Time passes.

Otto

* * *

>knock on door
This building is marked under abandonment, you don't need to knock or have a warrant to enter. Plus you want to avoid making your presence known to anybody inside. Stopping the perpetrator is your priority. Finding the girl safe, even more so.

Otto

>s
You walk down the porch, and around to the south side of the house.

Porch
The rough wood planks of the porch are weathered and stripped of their varnish years ago. They twitch at your movement. There are two windows here. The porch continues west to the side of the house.

Otto

>x window
Murky from dirt and dark from dusk, you can only make out the shapes of a table and some chairs. It looks like a parlour.

Otto

>x windows
Murky from dirt and dark from dusk, you can only make out the shapes of a table and some chairs. It looks like a parlour.

Otto

>look in window
Murky from dirt and dark from dusk, you can only make out the shapes of a table and some chairs. It looks like a parlour.

Otto

>open window
You can't seem to open the windows.

Otto

>attack window
You prefer finding a less noisy way inside.

Otto

* * *

>open window
You pull on the window frame, rust crumbles between the hinges. It swings open.

Otto

>open window
You pull on the window frame, rust crumbles between the hinges. It swings open.

Otto

>close window
You close the bay window.

Otto

* * *

>look in window
You see the parlour inside.

Otto

>enter window
Looking to make sure the room is empty, you slip inside.

Parlour
A large carpet covers the floor. A low and wide table dominates the room, tattered arm chairs guarding it. A silver serving dish is on the table. A bay window exits west, and there is a door to the north.

Otto

>showme parlour
Parlour - room
    bay window - open door
    Otto - man
        your badge
        gun
        torch - device
    living room door - closed door
    chair
    carpet
    table - supporter
        parlour-legs (part of table)
        serving dish - closed container
            *bone fragments
* denotes things which are not in scope
singular-named, improper-named; lighted, visited
list grouping key: none
printed name: "Parlour"
printed plural name: none
indefinite article: none
description: "A large carpet covers the floor. A low and wide table dominates the room, tattered arm chairs guarding it. A silver serving dish is on the table. A bay window exits west, and there is a door to the north."

Otto

>x chair
Torn and tattered, the floor looks more inviting.

Otto

>sit on chairs
You did not come here for the holiday.

Otto

>x floor
It's once-floral pattern, now faded by time and memory, reminds you of a muddy lily pond.

Otto

>x carpet
It's once-floral pattern, now faded by time and memory, reminds you of a muddy lily pond.

Otto

* * *

>x legs
The legs have scrolls at the top and bottom, spiralling in opposite directions. It must be hand carved.

Otto

>x dish
An undecorated silver dish, tarnished with age. A lid covers it.

Otto

* * *

>open dish
Despite this silly act of curiosity, you have to see what is on the dish. You have to be sure. You lift the lid to reveal bone fragments.

Otto

>l
Parlour
A large carpet covers the floor. A low and wide table dominates the room, tattered arm chairs guarding it. A silver serving dish is on the table. A bay window exits west, and there is a door to the north.

You can see a living room door here.

Otto

>x bones
These are his trophies. You are now convinced this is, or was, the right place.

Otto

>take bone fragments
No, they can be taken into evidence later. Time matters.

Otto

>take serving dish
No, they can be taken into evidence later. Time matters.

Otto

* * *

>enter window
Looking to make sure the room is empty, you slip inside.

Parlour
A large carpet covers the floor. A low and wide table dominates the room, tattered arm chairs guarding it. A silver serving dish is on the table. A bay window exits west, and there is a door to the north.

Otto

>x chairs
Torn and tattered, the floor looks more inviting.

Otto

* * *

>take carpet
That's hardly portable.

Otto

>shoot table
table is no threat to you.

Otto

>open door
You open the door as silently possible.

Otto

* * *

>n
Living room
An old couch rests against a wall, a painting hangs above it. A writing desk squats in one corner, and a serving trolley in the other. A door leads to the east, and some stairs go up to the second floor.

You can see a kitchen door and a painting here.

Otto

>x trolley
An rickety looking thing slanting to one side, two of the wheels are missing. It has a ceramic teapot and some cups on it. A hypodermic syringe and tourniquet also rest peacefully on top of the trolley.

Otto

>push trolley
It refuses to move.

Otto

>x wheel
The two remaining wheels are discs of black plastic.

Otto

>x teapot
A white ceramic teapot with a decorative design painted on the front: green leaves with violet and magenta orchid blooms. The handle in the shape of butterfly wings.

Otto

>x cup
Pale white tea cups without any designs.

Otto

* * *

>l
Living room
An old couch rests against a wall, a painting hangs above it. A writing desk squats in one corner, and a serving trolley in the other. A door leads to the east, and some stairs go up to the second floor.

You can see a kitchen door and a painting here.

Otto

>x painting
It depicts four men riding giant horses through the air, rolling clouds behind them. On the ground below, soldiers and slaves alike engage in a battle frenzy. You recognize the horsemen by name: Conquest, War, Famine and Death.

Otto

>x clouds
The clouds in the painting seem in turmoil, blocking out the entirety of the sky, except for one small patch at the very top. A lonesome white lamb floating in the open sky.

Otto

>x lamb
It watches the scene below with quiet indifference.

Otto

>x horsemen
Conquest wears fine clothes and wields a longbow, a crown adorns his head. The warrior, War, is swinging a two-handed broad sword. Famine holds a sling, dressed in rags and looking fierce. The skeleton that is Death grips a long staff, his gaze causing recoil in those who it falls upon.

Otto

>x desk
A squat dark wood desk. You notice engravings on it's surface.

Otto

* * *

>unlock door with bronze key
(the kitchen door with the bronze key)
The bronze key does not fit the kitchen door lock.

Otto

>go up
You peer up the staircase, making sure nobody else is watching from above, and cautiously ascend the stairs.

----------PAUSE----------
Your eyes flutter open.

Bedroom
A small bedroom furnished with a mattress on the floor. A door to the east leads to the loft, another door is due south.

On the mattress are a sheet and a torch.

The Girl

>open bedroom door
The bedroom door is locked.

The Girl

>x bed
A single sized mattress lies on the floor. It is covered in a pale white sheet.

On the mattress are a sheet and a torch.

The Girl

>take torch
You pick up the torch.

The Girl

* * *

>look through window
You see grass down below, no other houses are visible. You are on a second storey floor.

The Girl

>tie sheet to pipes
You wrap one end of the sheet around the pipes and make a knot.

The Girl

>tie sheet to mattress
You would achieve nothing by this.

The Girl

* * *

>look in window
You see the parlour inside.

Otto

>actions
Actions listing on.

Otto

>enter window
[entering the bay window]
[(1) going the bay window]
Looking to make sure the room is empty, you slip inside.

Parlour
You can see a living room door here.

[(1) going the bay window - succeeded]

[entering the bay window - succeeded]

Otto

* * *

Light pierces your vision as your eyes flutter open. Blurred shapes spin around as you shake the sound of a pounding heart free. You remember a struggle, the abduction, your name... nothing.

Third-floor-outside
Deliverance
A Halloween story by Wesley Werner
Release 1 / Serial number 161030 / Inform 7 build 6M62 (I6/v6.33 lib 6/12N) SD

Third-floor-outside

The Girl

>take all
sheet: You pick up the sheet.
torch: You pick up the torch.

The room turns into a tunnel, the floor rising up to meet you. Shadows creep in from all sides as your vision fades.
----------PAUSE----------
The last daylight creeps away, the moon struggles to find gaps through the looming thunder clouds. A chill moves over your skin.

Front of the house
You are in front of an old three storey house. The flaking paint and shoddy walkway indicate it's age and abandonment. The front door is here, the porch wraps around the building, towards the south. You are carrying your badge, gun and torch.

----------PAUSE----------
Your eyes flutter open.

Bedroom
A small bedroom furnished with a mattress on the floor. A door to the east leads to the loft, another door is due south.

The Girl

>l
Bedroom
A small bedroom furnished with a mattress on the floor. A door to the east leads to the loft, another door is due south.

Earlier today, an anonymous tip was called in at the homicide office. All they gave was a name, in connection with the missing girl.

The Girl

* * *

Light pierces your vision as your eyes flutter open. Blurred shapes spin around as you shake the sound of a pounding heart free. You remember a struggle, the abduction, your name... nothing.

Third-floor-outside
Deliverance
A Halloween story by Wesley Werner
Release 1 / Serial number 161030 / Inform 7 build 6M62 (I6/v6.33 lib 6/12N) SD

Third-floor-outside

The Girl

>z
Time passes.

The room turns into a tunnel, the floor rising up to meet you. Shadows creep in from all sides as your vision fades.
----------PAUSE----------
The last daylight creeps away, the moon struggles to find gaps through the looming thunder clouds. A chill moves over your skin.

Second Floor
You are in a hallway, stairs leading up and down are here. There is a gate at the top of the stairs. Doors to the north, east and south.

----------PAUSE----------
Your eyes flutter open.

Third-floor-outside
----------PAUSE----------
The last of the daylight vanishes. You are left in darkness.

Darkness
It is pitch dark, and you can't see a thing.

Otto

>z
Time passes.

Earlier today, an anonymous tip was called in at the homicide office. All they gave was a name, in connection with the missing girl.

Otto

>z
Time passes.

The name led to outdated property records, and those led to this address. Time is life, and death. I had to get here quick, even if my partner was an hour away the other direction. I had to.

Otto

>z
Time passes.

This place is derelict, remote and dreary. The perfect place to hide. Never have I wanted something so dismal to be so true. I pray she is alive.

Otto

* * *

>z
Time passes.

Otto

>z
Time passes.

The Girl

>z
Time passes.

The Girl

>take all
sheet: You pick up the sheet.
torch: You pick up the torch.

The Girl

>x window
You see grass down below, no other houses are visible. You are on a second storey floor.

The Girl

>open window
You open the escape-window.

The Girl

>actions
Actions listing on.

The Girl

>climb out window
I only understood you as far as wanting to climb outside.

The Girl

>climb on window
You can't see any such thing.

The Girl

>enter window
[entering the escape-window]
[(1) going the escape-window]
It is too high up, you will surely fall.
[(1) going the escape-window - failed]

[entering the escape-window - failed the convert enter door into go rule]

The Girl

>actions offf
I only understood you as far as wanting to actions.

The Girl

>actions off
Actions listing off.

The Girl

>tie sheet to pipes
That's already open.

You wrap one end of the sheet around the pipes and make a knot.

The Girl

>enter window
You hold on to the makeshift rope, climb through the window and prepare yourself.

The Girl

* * *

>z
Time passes.

Otto

>take all
sheet: You pick up the sheet.
torch: You pick up the torch.

The Girl

>tie sheet to pipes
You open the window.

You wrap one end of the sheet around the pipes and make a knot. You drop the other end of the sheet out the window.

The Girl

>climb out window
You hold on to the makeshift rope, climb through the window and prepare yourself.

The Girl

>climb window
Little is to be achieved by that.

The Girl

>exit
But you aren't in anything at the moment.

The Girl

* * *

>tie sheet to pipes
You open the window.

You wrap one end of the sheet around the pipes and make a knot. You drop the other end of the sheet out the window.

The Girl

>climb through window
You hold on to the makeshift rope, climb through the window and prepare yourself.

----------PAUSE----------
The last of the daylight vanishes. You are left in darkness.

Darkness
It is pitch dark, and you can't see a thing.

Otto

>l
Second Floor Hall

Otto

* * *

>climb through window
You hold on to the makeshift rope, climb through the window and prepare yourself.

----------PAUSE----------
The last of the daylight vanishes. You are left in darkness.

Darkness
It is pitch dark, and you can't see a thing.

Otto

>turn on torch
A bright beam flows out of your torch.

second floor hall

Otto

>go down
Living room
An old couch rests against a wall, a painting hangs above it. A writing desk squats in one corner, and a serving trolley in the other. A door leads to the east, and some stairs go up to the second floor.

You can see a kitchen door and a painting here.

Otto

>go up
second floor hall

Otto

* * *

>take all
sheet: You pick up the sheet.
torch: You pick up the torch.

The Girl

>open window
You open the escape-window.

The Girl

>tie sheet to pipes
You wrap one end of the sheet around the pipes and make a knot. You drop the other end of the sheet out the window.

The Girl

>climb out
You must name something more substantial.

The Girl

>climb through
What do you want to climb through?

The Girl

>climb through window
You hold on to the makeshift rope, climb through the window and prepare yourself.

The Girl

>showme third act
There seems to be no such object anywhere in the model world.

The Girl

* * *

>z
Time passes.

Otto

>turn on torch
A bright beam flows out of your torch.

Second Floor
You are in a hallway, stairs leading up and down are here. There is a gate at the top of the stairs. Doors to the north, east and south.

Otto

>n
bathroom
You are in a bathroom, there is a clawfoot bath, one window and a basin. A mirror is fixed to the wall. The exit is to the south.

You can see a window here.

Otto

>s
Second Floor
You are in a hallway, stairs leading up and down are here. There is a gate at the top of the stairs. Doors to the north, east and south.

Otto

>e
Second Floor Bedroom East

Otto

>w
Second Floor
You are in a hallway, stairs leading up and down are here. There is a gate at the top of the stairs. Doors to the north, east and south.

Otto

>s
Second Floor Bedroom South
The bedroom is somewhat furnished, a mattress is on the floor, a bedside table next to it. The windows are covered with sheets. It all looks old and dusty. Nobody has been in here for a long time.

You can see a second-mattress here.

Otto

>n
Second Floor
You are in a hallway, stairs leading up and down are here. There is a gate at the top of the stairs. Doors to the north, east and south.

Otto

>n
bathroom
You are in a bathroom, there is a clawfoot bath, one window and a basin. A mirror is fixed to the wall. The exit is to the south.

You can see a window here.

Otto

>take mirror
That's hardly portable.

Otto

>look in mirror
This determined gentleman has droopy violet eyes. His silky, wavy, vermilion hair is worn in a style that reminds you of a river. He has a graceful build. His skin is cream-colored. He has thin eyebrows. His wardrobe is classy, and is mostly gray.

Otto

>x window
The window is shoulder height, it leads to the outside.

Otto

>open window
You fail to push the window open. It must be secured.

Otto

>unlock window
What do you want to unlock the window with?

Otto

>unlock window with bronze key
The bronze key does not fit the window lock.

Otto

>i
You are carrying:
  a bronze key
  your badge
  a gun
  a torch (providing light)

Otto

>l
bathroom
You are in a bathroom, there is a clawfoot bath, one window and a basin. A mirror is fixed to the wall. The exit is to the south.

You can see a window here.

Otto

>s
Second Floor
You are in a hallway, stairs leading up and down are here. There is a gate at the top of the stairs. Doors to the north, east and south.

Otto

>s
Second Floor Bedroom South
The bedroom is somewhat furnished, a mattress is on the floor, a bedside table next to it. The windows are covered with sheets. It all looks old and dusty. Nobody has been in here for a long time.

You can see a second-mattress here.

Otto

>get on bed
This is no time to fool around!

Otto

>climb on bed
You can't see any such thing.

Otto

>climb on mattress
You can't see any such thing.

Otto

>get on mattress
This is no time to fool around!

Otto

* * *

Light pierces your vision as your eyes flutter open. Blurred shapes spin around as you shake the sound of a pounding heart free. You remember a struggle, the abduction, your name... nothing.

Third-floor-outside
Deliverance
A Halloween story by Wesley Werner
Release 1 / Serial number 161030 / Inform 7 build 6M62 (I6/v6.33 lib 6/12N) SD

Third-floor-outside

The Girl

>x mattress
A single sized mattress lies on the floor. It is covered in a pale white sheet.

On the mattress are a sheet and a torch.

The room turns into a tunnel, the floor rising up to meet you. Shadows creep in from all sides as your vision fades.
----------PAUSE----------
The last daylight creeps away, the moon struggles to find gaps through the looming thunder clouds. A chill moves over your skin.

second floor hall
----------PAUSE----------
Your eyes flutter open.

Bedroom
A small bedroom furnished with a mattress on the floor. A door to the east leads to the loft, another door is due south.

On the mattress are a sheet and a torch.

The Girl

>z
Time passes.

Earlier today, an anonymous tip was called in at the homicide office. All they gave was a name, in connection with the missing girl.

The Girl

>z
Time passes.

The name led to outdated property records, and those led to this address. Time is life, and death. I had to get here quick, even if my partner was an hour away the other direction. I had to.

The Girl

* * *

>z
Time passes.

This place is derelict, remote and dreary. The perfect place to hide. Never have I wanted something so dismal to be so true. I pray she is alive.

The Girl

>z
Time passes.

The Girl

>x mattress
A single sized mattress lies on the floor. It is covered in a pale white sheet.

On the mattress are a sheet and a torch.

The Girl

>x sheet
Pale from dirt.

The Girl

>x torch
A simple black plastic torch.

The torch is currently switched off.

The Girl

>take all
sheet: You pick up the sheet.
torch: You pick up the torch.

The Girl

>x pipes
They are painted the same as the faded white walls. You guess they carry water.

The Girl

* * *

>x window
You see grass down below, no other houses are visible. You are on a second storey floor.

The Girl

>l
Bedroom
A small bedroom furnished with a mattress on the floor. A door to the east leads to the loft, another door is due south.

The Girl

>open bedroom door
The bedroom door is locked.

The Girl

>open door
(the bedroom door)
The bedroom door is locked.

The Girl

>take pipes
They're hardly portable.

The Girl

* * *

Light pierces your vision as your eyes flutter open. Blurred shapes spin around as you shake the sound of a pounding heart free. You remember a struggle, the abduction, your name... nothing.

Third-floor-outside
Deliverance
A Halloween story by Wesley Werner
Release 1 / Serial number 161030 / Inform 7 build 6M62 (I6/v6.33 lib 6/12N) SD

Third-floor-outside

The Girl

>enter window
It is too high up, you will surely fall.

The room turns into a tunnel, the floor rising up to meet you. Shadows creep in from all sides as your vision fades.
----------PAUSE----------
The last daylight creeps away, the moon struggles to find gaps through the looming thunder clouds. A chill moves over your skin.

second floor hall
----------PAUSE----------
Your eyes flutter open.

Third Storey Outside
----------PAUSE----------
The last of the daylight vanishes. You are left in darkness.

Darkness
It is pitch dark, and you can't see a thing.

Otto