(as The Girl) You reach to bottom of the stairs, breathless and shaking.

Living room
The room is dim and nothing you see makes sense.

You can see a kitchen door and a painting here.

Living room
The room is dim and nothing you see makes sense.

You can see a kitchen door and a painting here.

Deliverance
A Halloween story by Wesley Werner
Release 1 / Serial number 161101 / Inform 7 build 6M62 (I6/v6.33 lib 6/12N) SD

Living room
The room is dim and nothing you see makes sense.

You can see a kitchen door and a painting here.

The Girl

>get up
You try to stand up. Your hands and feet are bound to the chair with rope, and you nearly topple over. The chair creaks violently.

The Girl

* * *

>get up
You rock the chair. Some part of it snaps underneath you, it sags to the right.

The Girl

>get up
You rock the chair. One one side of the chair breaks under the strain and you topple on to your side, your head almost hitting a small cardboard box. Your right arm is freed.

The Girl

>take box
You reach for the box. As you pull it closer it falls over, craft supplies spill out in front of you - some twine, a tube of hardened glue, pots of paints, a bottle of turpentine and a craft knife.

The Girl

>take craft knife
You pick up the craft knife carefully, avoiding the business end of it.

The Girl

>cut ropes
You curl up enough to reach your legs and sever the bonds around them. You get up into a kneeling position and cut your other arm free. You stand up, wobbling.

Loft
You are in what looks like a loft, crates and boxes stacked against the walls. Wooden floors and white walls surround you. The ceiling exposes rafters. There is a single window. There is a door to the west.

A small cardboard box is nearby.

You can also see a bottle of turpentine, pots of paints, a tube of hardened glue and some twine here.

The Girl

>w
(first opening the loft door)

You feel faint.

Bedroom
A small bedroom furnished with a mattress on the floor. A door to the east leads to the loft, another door is due south.

On the mattress is a torch.

The Girl

>take torch
You pick up the torch.

The room turns into a tunnel, the floor rising up to meet you. Shadows creep in from all sides as your vision fades.

press a key to continue...

* * *

(as The Girl) You reach to bottom of the stairs, breathless and shaking.

Living room
The room is dim and nothing you see makes sense.

You can see a kitchen door and a painting here.

Living room
The room is dim and nothing you see makes sense.

You can see a kitchen door and a painting here.

Deliverance
A Halloween story by Wesley Werner
Release 1 / Serial number 161101 / Inform 7 build 6M62 (I6/v6.33 lib 6/12N) SD

Living room
The room is dim and nothing you see makes sense.

You can see a kitchen door and a painting here.

The Girl

>x self
You see dirt on your bruised arms. You are wearing jeans and a t-shirt. Your hands are tied with ropes to the back of the chair, your feet tied to the legs of the chair.

The Girl

>x chair
It feels rickety and creaks when you move. You should try get up.

The Girl

>x ropes
They are bound around your hands and feet, fixing you to the chair.

The Girl

>take inventory
You are tied up and cannot search your pockets.

The Girl

>open door
You are tied up and cannot reach the door.

The Girl

>get up
You try to stand up. Your hands and feet are bound to the chair with rope, and you nearly topple over. The chair creaks violently.

The Girl

* * *

>get up
You rock the chair. One one side of the chair breaks under the strain and you topple on to your side, your head almost hitting a small cardboard box. Your right arm is freed.

The Girl

>open box
You reach for the box. As you pull it closer it falls over, craft supplies spill out in front of you - some twine, a tube of hardened glue, pots of paints, a bottle of turpentine and a craft knife.

The Girl

>x twine
a light string of two smaller strands.

The Girl

>take twine
You pick up the twine, and drop it despite your restraints.

The Girl

>x glue
The label reads "The Steel Queen Super Glue", the tube is rock hard.

The Girl

>take glue
You pick up the tube of hardened glue, and drop it despite your restraints.

The Girl

>x paints
Small pots of red, green and blue paints.

The Girl

>take paints
You pick up pots of paints, and drop it despite your restraints.

The Girl

>x bottle
"Grail of Fire Turpentine", the bottle is half full and smudged from usage.

The Girl

>take bottle
You pick up the bottle of turpentine, and drop it despite your restraints.

The Girl

>x knife
A partially rusted craft knife with a yellow plastic handle. The blade is still sharp.

The Girl

>take knife
You pick up the craft knife carefully, avoiding the business end of it.

The Girl

>cut ropes with the knife
You curl up enough to reach your legs and sever the bonds around them. You get up into a kneeling position and cut your other arm free. You stand up, wobbling.

Loft
You are in what looks like a loft, crates and boxes stacked against the walls. Wooden floors and white walls surround you. The ceiling exposes rafters. There is a single window. There is a door to the west.

A small cardboard box is nearby.

You can also see a bottle of turpentine, pots of paints, a tube of hardened glue and some twine here.

The Girl

>take all
bottle of turpentine: You pick up the bottle of turpentine.
pots of paints: You don't want the paints.
tube of hardened glue: You don't need dry glue.
twine: You pick up the twine.
small cardboard box: You don't want the empty box.

The Girl

>take box
You don't want the empty box.

The Girl

>take floor
That's hardly portable.

The Girl

>take wall
That's hardly portable.

The Girl

>take ceiling
That's hardly portable.

The Girl

>x floor
Dusty wooden floors.

The Girl

>x wall
White walls, lined with crates and boxes.

The Girl

>x rafters
The visible rafters make you think of an attic.

The Girl

>x door
A white wood door divided in four panels.

The Girl

>l
Loft
You are in what looks like a loft, crates and boxes stacked against the walls. Wooden floors and white walls surround you. The ceiling exposes rafters. There is a single window. There is a door to the west.

A small cardboard box is nearby.

You can also see pots of paints and a tube of hardened glue here.

The Girl

>x window
A small window allows a trickle of light into the room.

The Girl

* * *

>look out window
It is too far up, you can't see through it.

The Girl

>look through window
It is too far up, you can't see through it.

The Girl

>i
You are carrying:
  some twine
  a bottle of turpentine
  a craft knife

The Girl

>w
(first opening the loft door)

You feel faint.

Bedroom
A small bedroom furnished with a mattress on the floor and a curtain against one wall. The loft is back to the east, another door is due south.

On the mattress. are a sheet and a torch.

The Girl

>z
Time passes.

The room turns into a tunnel, the floor rising up to meet you. Shadows creep in from all sides as your vision fades.
----------PAUSE----------
The last daylight creeps away, the moon struggles to find gaps through the looming thunder clouds. A chill moves over your skin.

Front of the house
You are in front of an old three storey house. The flaking paint and shoddy walkway indicate it's age and abandonment. The front door is here, the porch wraps around the building, towards the south. You are carrying your badge, gun and torch.

Otto

>x badge
It reads: Detective Otto York. Homicide.

Otto

>x gun
A Glock 9mm, standard issue.

Earlier today, an anonymous tip was called in at the homicide office. All they gave was a name, in connection with the missing girl.

Otto

>x torch
A high-powered tactical torch.

The torch is currently switched off.

The name led to outdated property records, and those led to this address. Time is life, and death. I had to get here quick, even if my partner was an hour away the other direction. I had to.

Otto

>open door
You grasp the oval shaped metal door knob, with a firm grip you twist it back and forth. Locked.

This place is derelict, remote and dreary. The perfect place to hide. Never have I wanted something so dismal to be so true. I pray she is alive.

Otto

>attack door
This door may be old, but it is too solid to break down.

Otto

>knock on door
This building is marked under abandonment, you don't need to knock or have a warrant to enter. Plus you want to avoid making your presence known to anybody inside. Stopping the perpetrator is your priority. Finding the girl safe, even more so.

Otto

>s
You walk down the porch, and around to the south side of the house.

Porch
The rough wood of the porch is weathered and stripped of varnish. They twitch at your movement. There are two windows here. The porch continues west. The front door is back to the east.

Otto

>x window
Murky and dark, you can only make out the shapes of a table and some chairs. It looks like a parlour.

Otto

>x windows
Murky and dark, you can only make out the shapes of a table and some chairs. It looks like a parlour.

Otto

>look in window
Murky and dark, you can only make out the shapes of a table and some chairs. It looks like a parlour.

Otto

>open window
These windows are not supposed to open.

Otto

>attack window
You prefer finding a less noisy way inside.

Otto

>turn torch on
You don't need it right now.

Otto

>w
You walk along the porch to the west side of the house.

Rear of the house
The back of the house is no less weathered. There is a bay window here.

Otto

>x window
It is divided into four panes of glass, and sits about chest-height.

Otto

* * *

>open window
You pull on the window frame, rust crumbles between the hinges. It swings open.

Otto

>look in window
You see the parlour inside.

Otto

>enter window
Looking to make sure the room is empty, you slip inside.

Parlour
A large carpet covers the floor. A low and wide table dominates the room, tattered armchairs guarding it. A silver serving dish is on the table. A bay window is to the west, a door to the north.

Otto

>x chairs
Torn and tattered, the floor looks more inviting.

Otto

>sit in chair
You did not come here for the holiday.

Otto

>x carpet
It's once-floral pattern, now faded by time and memory, reminds you of a muddy lily pond.

Otto

>x table
A dark wood table with Flemish scroll style legs.

Otto

* * *

>x legs
The legs have scrolls at the top and bottom, spiralling in opposite directions. It must be hand carved.

Otto

>x serving dish
An undecorated silver dish, tarnished with age. A lid covers it.

Otto

>take serving dish
Despite this silly act of curiosity, you have to see what is on the dish. You have to be sure. You lift the lid to reveal bone fragments.

Otto

>x bone
These are his trophies. You are now convinced this is, or was, the right place.

Otto

>take serving dish
No, they can be taken into evidence later. Time matters.

Otto

>take bones
No, they can be taken into evidence later. Time matters.

Otto

>take table
That's hardly portable.

Otto

>take chair
That's hardly portable.

Otto

>take carpet
That's hardly portable.

Otto

>shoot table
Violence isn't the answer to this one.

Otto

>open door
You open the door as silently possible.

Otto

>n
Living room
An old couch rests against a wall, a painting hangs above it. A writing desk squats in one corner, and a serving trolley in the other. A door leads to the east, and some stairs go up to the second floor.

You can see a kitchen door and a painting here.

Otto

>x trolley
An rickety looking thing slanted to one side: two of the wheels are missing. It has a teapot and some teacups on it.

Otto

>push trolley
It is broken and refuses to move.

Otto

>x wheel
The two remaining wheels are discs of black plastic.

Otto

>x teapot
A white ceramic teapot with a decorative design painted on: green leaves with violet and magenta orchid blooms. The handle in the shape of butterfly wings.

Otto

>x cup
Pale white tea cups without any designs.

Otto

>take tea
You can't see any such thing.

Otto

>take teacup
You refuse to break for tea.

Otto

>take teapot
You refuse to break for tea.

Otto

>make tea
That's not a verb I recognise.

Otto

>open teapot
Lifting the butterfly lid, a bronze key is revealed inside the teapot.

Otto

>l
Living room
An old couch rests against a wall, a painting hangs above it. A writing desk squats in one corner, and a serving trolley in the other. A door leads to the east, and some stairs go up to the second floor.

You can see a kitchen door and a painting here.

Otto

>take key
You pick up the bronze key.

Otto

>l
Living room
An old couch rests against a wall, a painting hangs above it. A writing desk squats in one corner, and a serving trolley in the other. A door leads to the east, and some stairs go up to the second floor.

You can see a kitchen door and a painting here.

Otto

>x painting
It depicts four horsemen riding through the sky, rolling clouds behind them. On the earth below, soldiers and slaves alike engage in a battle frenzy. You recognize the horsemen by name: Conquest, War, Famine and Death.

Otto

>x clouds
The clouds in the painting seem in turmoil, blocking out the entirety of the sky, except for one small patch in the heavens above, occupied by a lonesome white lamb.

Otto

* * *

>x lamb
It watches the scene below with quiet indifference.

Otto

>x horsemen
Conquest wears fine clothes, wields a longbow and a crown adorns his head. War is swinging a two-handed broad sword. Famine holds a sling, dressed in rags and looking fierce. The skeleton that is Death grips a long staff, his gaze causing recoil in those who it falls upon.

Otto

>x desk
A squat dark wood desk. You notice engravings on it's surface.

Otto

>x engravings
Names carved into the varnished wood. You read: Annette Faith Parker. Meghan Mcclure. Jami Berg. All previous victims.

Otto

>take painting
That's fixed in place.

Otto

>x door
(the kitchen door)
You see nothing special about the kitchen door.

Otto

>open door
(the kitchen door)
The kitchen door is locked.

Otto

>unlock door with bronze key
(the kitchen door with the bronze key)
The bronze key does not fit the kitchen door lock.

Otto

>go up
You peer up the staircase, making sure nobody else is watching from above, and cautiously ascend the stairs.

----------PAUSE----------
(as The Girl) Your eyes flutter open.

Bedroom
A small bedroom furnished with a mattress on the floor and a curtain against one wall. The loft is back to the east, another door is due south.

On the mattress. are a sheet and a torch.

The Girl

>open bedroom door
The bedroom door is locked.

The Girl

>x bed
A single sized mattress lies on the floor. It is covered in a pale white sheet.

On the mattress. are a sheet and a torch.

The Girl

>take torch
You pick up the torch.

The Girl

>x sheet
Pale from dirt.

The Girl

>take sheet
You pick up the sheet.

The Girl

>look under mattress
You find nothing of interest.

The Girl

>x pipes
They are painted the same as the faded white walls. You guess they carry water.

The Girl

>x window
You see grass down below, no other houses are visible. You are on a second storey floor.

The Girl

>look through window
You see grass down below, no other houses are visible. You are on a second storey floor.

The Girl

>tie sheet to pipes
You open the window.

You wrap one end of the sheet around the pipes and make a knot. You drop the other end of the sheet out the window.

The Girl

>tie sheet to mattress
You would achieve nothing by this.

The Girl

>tie sheet to pipes
It is already tied.

The Girl

>climb out the window
You hold on to the makeshift rope, climb through the window and prepare yourself.

----------PAUSE----------
As you reach the top of the second floor, the last of the daylight vanishes. You are left in darkness.

Darkness
It is pitch dark, and you can't see a thing.

Otto

>i
You are carrying:
  a bronze key
  your badge
  a gun
  a torch

Otto

>switch torch on
A bright beam flows out of your torch.

Second Floor
You are in the second floor hallway. Here are stairs that lead up to the third floor, protected by a security gate. You can go back down to the first floor. You see doors to the north, east and south.

Otto

>n
bathroom
You are in a bathroom, there is a claw-foot bath, one window and a basin. A mirror is fixed to the wall. The exit is to the south.

You can see a window here.

Otto

>x bath
A stained white claw-foot bath. The feet are metal and have decorative faces moulded into them.

Otto

>x claw-foot
You can't see any such thing.

Otto

>x foot
You can't see any such thing.

Otto

>x faces
You do not recognize the moulded faces.

Otto

* * *

>get in bath
Taking a bath at this point is utterly ridiculous.

Otto

>x basin
A simple pedestal basin of white ceramic.

Otto

* * *

>x mirror
A rectangular mirror without any frame. The edges of the glass are stained.

Otto

>search mirror
This determined gentleman has droopy violet eyes. His silky, wavy, vermilion hair is worn in a style that reminds you of a river. He has a graceful build. His skin is cream-coloured. He has thin eyebrows. His wardrobe is classy, and is mostly grey.

Otto

>x window
The window is shoulder height, it leads to the outside.

Otto

* * *

>open window
It won't open. It must be secured permanently.

Otto

>shoot window
Violence isn't the answer to this one.

Otto

>s
Second Floor
You are in the second floor hallway. Here are stairs that lead up to the third floor, protected by a security gate. You can go back down to the first floor. You see doors to the north, east and south.

Otto

>s
Bedroom
The bedroom is somewhat furnished, a mattress is on the floor, a bedside table next to it. The window is covered with a sheet.

On the the table are some newspapers.

You can also see a second-mattress here.

Otto

>x mattres
You can't see any such thing.

Otto

>x mattress
A single mattress on the floor.

Otto

>x bed
A single mattress on the floor.

Otto

>look under mattress
You find nothing of interest.

Otto

>x table
A low bedside table, some newspapers are on it.

On the the table are some newspapers.

Otto

>read newspapers
These are fairly recent, somebody is living here.

Otto

>take newspapers
You don't want the newspapers.

Otto

>n
Second Floor
You are in the second floor hallway. Here are stairs that lead up to the third floor, protected by a security gate. You can go back down to the first floor. You see doors to the north, east and south.

Otto

>e
Bedroom
This room is bare, save for some dust covering the floor. There is one lonely window.

Otto

* * *

>x window
You see grass down below, no other houses are visible. You are on a second storey floor.

Otto

>open window
You can't seem to open the window.

Otto

* * *

>w
Second Floor
You are in the second floor hallway. Here are stairs that lead up to the third floor, protected by a security gate. You can go back down to the first floor. You see doors to the north, east and south.

Otto

>go up
(first opening the security gate)
the security gate is locked.

Otto

>unlock gate with key
You unlock the security gate.

Otto

>go up
You open the security gate.

You ascend the stairs, continuing your search...

----------PAUSE----------
You hold tight to the bed sheet as you climb through the window. You hear a noise coming from the other side of the bedroom door, fear rises up inside. You pull the curtain closed, hoping to hide your escape attempt.

Hanging Outside, third storey
You are hanging outside the third storey window, gripping the bed sheet tied inside the room. You can go down.

The Girl

* * *

(as The Girl) You reach to bottom of the stairs, breathless and shaking.

Living room
The room is dim and nothing you see makes sense.

You can see a kitchen door and a painting here.

Living room
The room is dim and nothing you see makes sense.

You can see a kitchen door and a painting here.

Deliverance
A Halloween story by Wesley Werner
Release 1 / Serial number 161101 / Inform 7 build 6M62 (I6/v6.33 lib 6/12N) SD

Living room
The room is dim and nothing you see makes sense.

You can see a kitchen door and a painting here.

The Girl

>z
Time passes.

The Girl

>z
You are wasting time!

Otto

>z
Time passes.

The name led to outdated property records, and those led to this address. Time is life, and death. I had to get here quick, even if my partner was an hour away the other direction. I had to.

The Girl

>z
Time passes.

This place is derelict, remote and dreary. The perfect place to hide. Never have I wanted something so dismal to be so true. I pray she is alive.

The Girl

>z
Time passes.

Otto

* * *

>z
You are wasting time!

Otto

>w
No time to run away, you must stop him!

Otto

>open curtain
You can't see any such thing.

Otto

>open door
(the kitchen door)
The kitchen door is locked.

Otto

>shoot door
(the kitchen door)
Violence isn't the answer to this one.

Otto

>s
No time to run away, you must stop him!

Otto

>x floor
You can't see any such thing.

Otto

>x floors
You can't see any such thing.

Otto

>x cupboard
You can't see any such thing.

Otto

>open cupboards
You can't see any such thing.

Otto

>w
No time to run away, you must stop him!

Otto

>x table
You can't see any such thing.

Otto

>take knife
You can't see any such thing.

Otto

>i
You are carrying:
  a bronze key
  your badge
  a gun
  a torch

Otto

>w
No time to run away, you must stop him!

Otto

>actions
Actions listing on.

The Girl

>l
[looking]
The room is dim and nothing you see makes sense.
[looking - failed]

The Girl

>s
[going south]
NO[going south - failed the Check going during the eighth act]

The Girl

>e
[going east]
NO[going east - failed the Check going during the eighth act]

The Girl

* * *

>w
No time to run away, you must stop him!

Otto

>w
The kitchen door opens, a shape moves out from the shadow. You see the killer, moving towards you with a knife. You scream.
You can't, you are frozen with fear!

Tad moves closer to you, a cleaver in his hand...

The Girl

>l
Living room
The room is dim and nothing you see makes sense.

You can see Tad, a kitchen door and a painting here.

Tad moves closer to you, a cleaver in his hand...

The Girl

>e
You can't, you are frozen with fear!

Tad moves closer to you, a cleaver in his hand...

The Girl

* * *

>w
No time to run away, you must stop him!

Otto

>z
You are wasting time!

Otto

>z
Time passes.

The Girl

>s
The kitchen door opens, a shape moves out from the shadow. You see the killer, moving towards you with a knife. You scream.
You can't, you are frozen with fear!

Tad moves closer to you, a cleaver in his hand...

The Girl

>z
Time passes.

Tad moves closer to you, a cleaver in his hand...

The Girl

* * *

>w
No time to run away, you must stop him!

Otto

>attack tad with the craft knife
You can't see any such thing.

Otto

>attack tad
You can't see any such thing.

Otto

>z
You are wasting time!

Otto

>z
You are wasting time!

Otto

>x girl
You are wasting time!

Otto

>x victoria
You are wasting time!

Otto

>s
No time to run away, you must stop him!

Otto

>shoot tad
You aim your pistol at the man, you exhale and squeeze the trigger. The killer drops to the floor.

----------PAUSE----------
Otto

* * *

>z
You are wasting time!

Otto

>attack tad
You slip the craft knife into your palm, scared to death, your limbs seem to move on their on volition. You slash at the killer's back, blood gushes out. More blood than you ever saw.

----------PAUSE----------
The Girl

* * *

>z
You are wasting time!

Otto

>s
No time to run away, you must stop him!

Otto

>z
You are wasting time!

Otto

>attack tad with the craft knife
You can't see any such thing.

Otto

* * *

>open curtain
You can't see any such thing.

Otto

>climb out window
Otto

>n
(first opening the window)
You can't, since the window leads nowhere.

Otto

>enter window
You grab the sheet and climb through the window.

Hanging outside the third floor
You are hanging outside the third storey window, gripping the bed sheet tied inside the room. You can go down.

Otto

* * *

>open curtain
You can't see any such thing.

Otto

>climb through window
You grab the sheet and climb through the window.

Hanging outside the third floor
You are hanging outside the third storey window, gripping the bed sheet tied inside the room. You can go down.

Otto

>enter window
You are wasting time. You can't back out with your choice now.

Otto

>enter window
You are wasting time. You can't back out with your choice now.

Otto

>go down
Lowering yourself down, one handful at a time, you reach the end of the sheet.

Hanging outside the second floor
You are hanging outside a window. You are at the end of the sheet, and cannot go down any more.

You can see a window here.

Otto

>climb through window
You manage to squeeze your way through the broken frame, which is not that large for a man of your build. You cut your right forearm in the process. You hear a chilling scream come from down below. You get up, and dash down the stairs...

----------PAUSE----------
(as Tad) The room is very dim, all of them are, in hell. You have been hiding from the Demons that hunt you. Everywhere you go, they follow. Angry nasty demons that want your flesh. You managed to trap one of them, now locked in the attic.

Kitchen
You can see a kitchen door here.

Tad

* * *

>z
Time passes.

The Girl

>x window
You are hanging outside the window

The Girl

>climb through window
You won't dare go back into that room, not with somebody just outside the door.

The Girl

>showme window
(the the window)
the window - thing
location: in Hanging outside the third floor
singular-named, improper-named; unlit, inedible, fixed in place, scenery
list grouping key: none
printed name: "the window"
printed plural name: none
indefinite article: none
description: "You are hanging outside the window"
initial appearance: none

The Girl

>hit window
Violence isn't the answer to this one.

The Girl

>x sheet
You are hanging on to the sheet for dear life.

The Girl

>go down
Lowering yourself down, one handful at a time, you reach the end of the sheet.

Hanging outside the second floor
You are hanging outside a window. You are at the end of the sheet, and cannot go down any more.

You can see a window here.

The Girl

* * *

>x sheet
You are hanging on to the sheet for dear life.

The Girl

>open window
You struggle to open the window, maybe a little force is called for.

The Girl

>kick window
You kick the window and shatter the glass pane. You should be able to fit through it.

The Girl

>climb through window
You raise your legs through the opening and lower yourself into the room.

bathroom
You are in a bathroom, there is a claw-foot bath, one window and a basin. A mirror is fixed to the wall. The exit is to the south.

You can see a window here.

The Girl

>showme window
(the window)
window - locked door
location: in bathroom
singular-named, improper-named; unlit, inedible, fixed in place; open, openable, lockable, locked
list grouping key: none
printed name: "window"
printed plural name: "doors"
indefinite article: none
description: "The window is shoulder height, it leads to the outside."
initial appearance: none
other side: Hanging outside the second floor

The Girl

>enter window
Hanging outside the second floor
You are hanging outside a window. You are at the end of the sheet, and cannot go down any more.

You can see a window here.

The Girl

* * *

>climb through window
You raise your legs through the opening and lower yourself into the room.

bathroom
You are in a bathroom, there is a claw-foot bath, one window and a basin. A mirror is fixed to the wall. The exit is to the south.

You can see a window here.

The Girl

>x window
A chipped white frame with murky glass panes.

The Girl

>climb through window
You are not going back up there.

The Girl

>goup
That's not a verb I recognise.

The Girl

>go up
You refuse to climb back up.

The Girl

* * *

>climb through window
You are not going back up there.

The Girl

>x mirror
A rectangular mirror without any frame. The edges of the glass are stained.

The Girl

* * *

>look in mirror
You look at yourself in the mirror: Big orange eyes stare back at you. Your straight brown hair is tangled about your face. You look like hell.

The Girl

>x self
You see dirt on your bruised arms. You are wearing red jeans and a yellow blouse. 

The Girl

>get in bath
You would love a bath, anywhere but here.

The Girl

>s
Second Floor
You are in the second floor hallway. Here are stairs that lead up to the third floor, protected by a security gate. You can go back down to the first floor. You see doors to the north, east and south.

The Girl

>i
You are carrying:
  a craft knife

The Girl

>s
You feel the urgent need to get out of here, quick. You don't want to find out who is in those rooms!

The Girl

* * *

>n
You feel the urgent need to get out of here, quick. You don't want to find out who is in those rooms!

The Girl

>down
Frightened and shaking, you go down the stairs...
----------PAUSE----------
(as Otto) You run up the stairs and enter an empty room to the north. You scan the room: a lonely mattress, and a doorway to your right leading to a loft. You see a broken chair and cut bonds next to it. You dash into the loft.

Loft
You are in what looks like a loft, crates and boxes stacked against the walls. Wooden floors and white walls surround you. The ceiling exposes rafters. There is a single window. There is a door to the west.

Otto

* * *

>n
You feel the urgent need to get out of here, quick. You don't want to find out who is in those rooms!

The Girl

>up
You feel the urgent need to get out of here, quick. You don't want to find out who is in those rooms!

The Girl

>down
Frightened and shaking, you go down the stairs...
----------PAUSE----------
(as Otto) You reach the top of the stairs, an open bedroom door in front of you. Stepping inside, you see a doorway leading to a loft: a broken chair and cut bonds inside. You dash into the loft...

Loft
You are in what looks like a loft, crates and boxes stacked against the walls. Wooden floors and white walls surround you. The ceiling rafters are visible. There is a single window. There is a door to the west.

A broken chair and cut rope lies on the floor.

Otto

>x chair
Some of the legs are snapped off.

The loft door slams shut behind you!

Otto

>x rope
They are cut to pieces.

Otto

>take crates
They're hardly portable.

Otto

>w
(first opening the loft door)

Bedroom
A small bedroom furnished with a mattress on the floor and a curtain against one wall. The loft is back to the east, another door is due south.

On the mattress are a sheet and a torch.

Otto

>s
(first opening the bedroom door)
Someone has locked the bedroom door!

Otto

>open curtain
You pull the curtain open, there is a window behind it. Near the floor are some pipes.

Someone has tied a bed sheet to the pipes, and hung the other end out the window.

Otto

>l
Bedroom
A small bedroom furnished with a mattress on the floor and a curtain against one wall, a window behind it. Some pipes run along the wall behind the curtain. The loft is back to the east, another door is due south.

A bed sheet is tied to the pipes, the other end hanging out the window.

On the mattress are a sheet and a torch.

Otto

* * *

>z
Time passes.

The Girl

>e
The kitchen door opens, a shape moves out from the shadow. You see the killer, moving towards you with a knife. You scream.
You can't, you are frozen with fear!

Tad moves closer to you, a cleaver in his hand...

The Girl

>attack tad
The knife is in your pocket. You limbs feel frozen, you cannot move while he glares at you.

Tad moves closer to you, a cleaver in his hand...

The Girl

>z
Time passes.

Tad moves closer to you, a cleaver in his hand...

The Girl

>z
Time passes.

Tad moves closer to you, a cleaver in his hand...

There is movement to your right, a detective on the stairs! They aim their gun at the killer with a bloodied, shaking arm. The gun fires.
----------PAUSE----------
The shot missed! The killer turns to the detective. Now is your chance!

The Girl

>z
You are wasting time!

The Girl

I beg your pardon?

The Girl

>attack tad
You slip the craft knife into your palm, scared to death, your limbs seem to move on their on volition. You slash at the killer's back, blood gushes out. More blood than you ever saw.

----------PAUSE----------
The Girl

* * *

(as The Girl) You reach to bottom of the stairs, breathless and shaking.

Living room
The room is dim and nothing you see makes sense.

You can see a kitchen door and a painting here.

Living room
The room is dim and nothing you see makes sense.

You can see a kitchen door and a painting here.

Deliverance
A Halloween story by Wesley Werner
Release 1 / Serial number 161101 / Inform 7 build 6M62 (I6/v6.33 lib 6/12N) SD

Living room
The room is dim and nothing you see makes sense.

You can see a kitchen door and a painting here.

The Girl

>x girl
You can't see any such thing.

Otto

* * *

(as The Girl) You reach to bottom of the stairs, breathless and shaking.

Living room
The room is dim and nothing you see makes sense.

You can see a kitchen door and a painting here.

Living room
The room is dim and nothing you see makes sense.

You can see a kitchen door and a painting here.

Deliverance
A Halloween story by Wesley Werner
Release 1 / Serial number 161101 / Inform 7 build 6M62 (I6/v6.33 lib 6/12N) SD

Living room
The room is dim and nothing you see makes sense.

You can see a kitchen door and a painting here.

The Girl

>showme victoria
The Girl - woman
    craft knife
location: in Bedroom
singular-named, proper-named; unlit, inedible, portable; female, untied
list grouping key: none
printed name: "Victoria Cote"
printed plural name: "women"
indefinite article: none
description: "This girl puts you in mind of a frightened cat. She has large orange eyes that are like two flames. Her messy, straight, brown hair is worn in a style that reminds you of a comet's trail. She is short and has an hourglass build. Her skin is cream-coloured. She has a high forehead and wide feet. Her wardrobe is strange."
initial appearance: none
carrying capacity: 100
self description: "You see dirt on your bruised arms. You are wearing red jeans and a yellow blouse. "
mirror description: "Big orange eyes stare back at you. Your straight brown hair is tangled about your face. You look like hell."

Otto

* * *

(as The Girl) You reach to bottom of the stairs, breathless and shaking.

Living room
The room is dim and nothing you see makes sense.

You can see a kitchen door and a painting here.

Living room
The room is dim and nothing you see makes sense.

You can see a kitchen door and a painting here.

Deliverance
A Halloween story by Wesley Werner
Release 1 / Serial number 161101 / Inform 7 build 6M62 (I6/v6.33 lib 6/12N) SD

Living room
The room is dim and nothing you see makes sense.

You can see a kitchen door and a painting here.

The Girl

>shoot tad
You aim your pistol at the man, you exhale and squeeze the trigger. The killer drops to the floor.

----------PAUSE----------
Otto

* * *

(as The Girl) You reach to bottom of the stairs, breathless and shaking.

Living room
The room is dim and nothing you see makes sense.

You can see a kitchen door and a painting here.

Living room
The room is dim and nothing you see makes sense.

You can see a kitchen door and a painting here.

Deliverance
A Halloween story by Wesley Werner
Release 1 / Serial number 161101 / Inform 7 build 6M62 (I6/v6.33 lib 6/12N) SD

Living room
The room is dim and nothing you see makes sense.

You can see a kitchen door and a painting here.

The Girl

>l
Living room
The room is dim and nothing you see makes sense.

You can see Tad, a kitchen door and a painting here.

Tad moves closer to you, a cleaver in his hand...

The Girl

* * *

(as The Girl) You reach to bottom of the stairs, breathless and shaking.

Living room
The room is dim and nothing you see makes sense.

You can see a kitchen door and a painting here.

Living room
The room is dim and nothing you see makes sense.

You can see a kitchen door and a painting here.

Deliverance
A Halloween story by Wesley Werner
Release 1 / Serial number 161101 / Inform 7 build 6M62 (I6/v6.33 lib 6/12N) SD

Living room
The room is dim and nothing you see makes sense.

You can see a kitchen door and a painting here.

The Girl

>w
The kitchen door opens, a shape moves out from the shadow. You see the killer, moving towards you with a knife. You scream.
You can't, you are frozen with fear!

Tad moves closer to you, a cleaver in his hand...

The Girl

>attack tad
The knife is in your pocket. You limbs feel frozen, you cannot move while he glares at you.

Tad moves closer to you, a cleaver in his hand...

The Girl

* * *

>z
Time passes.

Tad moves closer to you, a cleaver in his hand...

The Girl

>z
Time passes.

Tad moves closer to you, a cleaver in his hand...

You close your eyes.
----------PAUSE----------
(as Otto) You reach the bottom of the stairs. The girl is here, the killer going for her...

Living room
The room is dim and nothing you see makes sense.

You can see Tad, The Girl, a kitchen door and a painting here.

Otto

>z
You are wasting time!

Otto

>attack tad
You aim your pistol at the man, you exhale and squeeze the trigger. The killer drops to the floor.

----------PAUSE----------
Otto