Light pierces your vision as your eyes flutter open. Blurred shapes spin around as you shake the sound of a pounding heart free. You remember the struggle and abduction, but not your name...

# BETA RELEASE
# Enter SCRIPT as your first command to record your session. You can add annotations during play via "?" or "!" prefixes: "? I have no idea what to do" or "! This thing is really lame"

Deliverance
Some demons are more real than others, by Wesley Werner
Release 1 / Serial number 161106 / Inform 7 build 6M62 (I6/v6.33 lib 6/12N) SD

Loft (on the chair)
You don't know where you are, some kind of room. You feel too panicked to notice your surroundings. It is difficult to move.

The Girl

>get up
You try to stand up. Your hands and feet are bound to the chair with rope, and you nearly topple over. The chair creaks violently.

The Girl

>x chair
It feels rickety and creaks when you move. You should try get up.

The Girl

>x self
You see dirt on your bruised arms. You are wearing red jeans and a yellow blouse. Your hands are tied with ropes to the back of the chair, your feet tied to the legs of the chair.

The Girl

>x ropes
They are bound around your hands and feet, fixing you to the chair.

The Girl

>untie ropes
You struggle to untie the knots. There must be another way.

The Girl

>take ropes
Ironically you are tied up with the very rope you want to take.

The Girl

>get up
You rock the chair. Some part of it snaps underneath you, it sags to the right.

The Girl

>get up
You rock the chair. One one side of the chair breaks under the strain and you topple on to your side, your head almost hitting a small cardboard box. Your one arm is freed.

The Girl

>x self
You see dirt on your bruised arms. You are wearing red jeans and a yellow blouse. Your hands are tied with ropes to the back of the chair, your feet tied to the legs of the chair.

The Girl

>x chair
It feels rickety and creaks when you move. You should try get up.

The Girl

>take ropes
Ironically you are tied up with the very rope you want to take.

The Girl

>untie ropes
You struggle to untie the knots. There must be another way.

The Girl

>get up
You struggle to raise yourself up from this position.

The Girl

>x box
A small closed box.

The Girl

>take box
You reach for the box. As you pull it closer it falls over, craft supplies spill out in front of you - some twine, a tube of hardened glue, pots of paints, a bottle of lamp oil and a craft knife.

The Girl

>take knife
You pick up the craft knife carefully, avoiding the business end of it.

The Girl

>x knife
A partially rusted craft knife with a yellow plastic handle. The blade is still sharp.

The Girl

>cut ropes
You curl up enough to reach your legs and sever the bonds around them. You get up into a kneeling position and cut your other arm free. You stand up, wobbling.

Loft
You are in what looks like a loft, crates and boxes stacked against the walls. Wooden floors and white walls surround you. The ceiling rafters are visible. There is a single window. There is a door to the west.

A broken chair and cut rope lies on the floor.

A small cardboard box is nearby.

You can also see a bottle of lamp oil, pots of paints, a tube of hardened glue and some twine here.

The Girl

>take lamp oil
You pick up the bottle of lamp oil.

The Girl

>x paints
Small pots of red, green and blue paints.

The Girl

>take paints
You don't want the paints.

The Girl

>x glue
The label reads "The Steel Queen Super Glue", the tube is rock hard.

The Girl

>take glue
You don't need dry glue.

The Girl

>x oil
"Grail of Fire Lamp Oil", the bottle is half full and smudged from usage.

The Girl

>x twine
a light string of two smaller strands.

The Girl

>take twine
You pick up the twine.

The Girl

>x window
A small window allows a trickle of light into the room.

The Girl

>look out window
It is too far up, you can't see through it.

The Girl

>x rafters
The visible rafters make you think of an attic.

The Girl

>x floor
Dusty wooden floors.

The Girl

>x ceiling
The visible rafters make you think of an attic.

The Girl

>x walls
White walls, lined with crates and boxes.

The Girl

>x crates
You don't want to rummage through old boxes when you feel a strong need to get out of here.

The Girl

>open crates
You can't seem to open the boxes.

The Girl

>w
(first opening the loft door)

You feel faint.

Bedroom
A small bedroom furnished with a mattress on the floor and a curtain against one wall. The loft is back to the east, another door is due south.

On the mattress is a sheet.

The Girl

>z
Time passes.

The room turns into a tunnel, the floor rising up to meet you. Shadows creep in from all sides as your vision fades.

press a key to continue...

(as Otto) The last daylight creeps away, the moon struggles to find gaps through looming clouds. A chill moves over your skin.

Front of the house
You are in front of an old house. The flaking paint and shoddy walkway indicate it's age and abandonment. The front door is here, the porch wraps around the building, towards the south. You are carrying your badge, gun and torch.

Otto

* * *

>get up
You try to stand up. Your hands and feet are bound to the chair with rope, and you nearly topple over. The chair creaks violently.

The Girl

>get up
You rock the chair. Some part of it snaps underneath you, it sags to the right.

The Girl

>get up
You rock the chair. One side of the chair breaks under the strain and you topple onto your side, your head almost hitting a small cardboard box. Your one arm is freed.

The Girl

>take box
You reach for the box. As you pull it closer it falls over, craft supplies spill out in front of you - some twine, a tube of hardened glue, pots of paints, a bottle of lamp oil and a craft knife.

The Girl

* * *

>take knife
You pick up the craft knife carefully, avoiding the business end of it.

The Girl

>cut ropes with knife
You curl up enough to reach your legs and sever the bonds around them. You get up into a kneeling position and cut your other arm free. You stand up, wobbling.

Loft
You are in what looks like a loft, crates and boxes stacked against the walls. Wooden floors and white walls surround you. The ceiling rafters are visible. There is a single window. There is a door to the west.

A broken chair and cut rope lies on the floor.

A small cardboard box is nearby.

You can also see a bottle of lamp oil, pots of paints, a tube of hardened glue and some twine here.

The Girl

>take lamp oil
You pick up the bottle of lamp oil.

The Girl

>w
(first opening the loft door)

You feel faint.

Bedroom
A small bedroom furnished with a mattress on the floor and a curtain against one wall. The loft is back to the east, another door is due south.

On the mattress is a sheet.

The Girl

* * *

>z
Time passes.

The room turns into a tunnel, the floor rising up to meet you. Shadows creep in from all sides as your vision fades.

press a key to continue...

(as Otto) The last daylight creeps away, the moon struggles to find gaps through looming clouds. A chill moves over your skin.

Front of the house
You are in front of an old house. The flaking paint and shoddy walkway indicate it's age and abandonment. The front door is here, the porch wraps around the building, towards the south. You are carrying your badge, gun and torch.

Otto

>s
You walk down the porch, and around to the south side of the house.

Porch
The rough wood of the porch is weathered and stripped of varnish. There are two windows here. The porch continues west. The front door is back to the north.

Otto

>w
You walk along the porch to the west side of the house.

Rear of the house
The back of the house is no less weathered. There is a bay window here.

Earlier today, an anonymous tip was called in at the homicide office. All they gave was a name, in connection with the missing girl.

Otto

>open bay window
You pull on the window frame, rust crumbles between the hinges. It swings open.

The name led to outdated property records, and those led to this address. I had to get here quick, even if my partner was an hour away in the other direction. I had to.

Otto

>climb in bay window
Looking to make sure the room is empty, you slip inside.

Parlour
A large carpet covers the floor. A low and wide table dominates the room, tattered armchairs guarding it. A silver serving dish is on the table. A bay window is to the west, a door to the north.

This place is derelict, remote and dreary. The perfect place to hide an abducted girl. Never have I wanted something so dismal to be so true. I pray she is alive.

Otto

>n
(first opening the living room door)
You open the door as silently possible.

Living room
An old couch rests against a wall, a painting hangs above it. A writing desk squats in one corner, and a serving trolley in the other. A door to the south leads back to the Parlour, another leads to the east. Stairs go up to the second floor.

Otto

>open teapot
Lifting the butterfly lid, a business card is revealed inside the teapot.

Otto

>take business card
You pick up the business card.

Otto

>go up
You peer up the staircase, making sure nobody else is watching from above, and cautiously ascend the stairs.

press a key to continue...

(as The Girl) Your eyes flutter open.

Bedroom
A small bedroom furnished with a mattress on the floor and a curtain against one wall. The loft is back to the east, another door is due south.

On the mattress is a sheet.

The Girl

>open curtain
You pull the curtain open, there is a window behind it. Near the floor are some pipes.

The Girl

>take sheet
You pick up the sheet.

The Girl

>tie sheet to pipes
You open the window.

You wrap one end of the sheet around the pipes and make a knot. You drop the other end of the sheet out the window.

The Girl

>climb out window
You hold on to the makeshift rope, climb through the window and prepare yourself.

press a key to continue...

(as Otto) As you reach the top of the second floor, the last of the daylight vanishes. You are left in darkness.

Darkness
It is pitch dark, and you can't see a thing.

Otto

>switch torch on
A bright beam flows out of your torch.

Second Floor
You are in the second floor hallway. Here are stairs that lead up to the third floor, protected by a security gate. You can go back down to the first floor. You see doors to the north, east and south.

Otto

>s
Bedroom
The bedroom is somewhat furnished, a mattress on the floor serves as a bed, a bedside table next to it. The window is covered with a sheet. There is something under the table.

Otto

>look under table
You see a safe under the table.

Otto

>x keypad
An electronic pad for entering a code. You can ENTER 0000 to unlock the safe.

Otto

>x business card
"Unholy Battle pest control, Tad Kemp". You notice an impression like writing on the back of the card.

Otto

>turn business card
The back of the card has 6375 written on it.

Otto

>enter 6375
(in the keypad)
Click. The safe door creaks open. Inside is a bronze key.

Otto

>take bronze key
You pick up the bronze key.

Otto

>n
Second Floor
You are in the second floor hallway. Here are stairs that lead up to the third floor, protected by a security gate. You can go back down to the first floor. You see doors to the north, east and south.

Otto

>unlock gate with bronze key
You unlock the security gate.

Otto

>go up
You open the security gate.

You ascend the stairs, continuing your search...

press a key to continue...

(as The Girl) You hold tight to the bed sheet as you climb through the window. You hear a noise coming from the other side of the bedroom door, fear rises up inside. You pull the curtain closed, hoping to hide your escape attempt.

Waiting Room
You can see your former self here.

Hanging outside the third floor
You are hanging outside the third storey window, gripping the bed sheet tied inside the room. You can go down.

The Girl

>go down
Lowering yourself down, one handful at a time, you reach the end of the sheet.

Hanging outside the second floor
You are hanging outside a window. You are at the end of the sheet, and cannot go down any more.

You can see a window here.

The Girl

>kick window
You kick the window and shatter the glass pane. You should be able to fit through it.

The Girl

>climb through window
You raise your legs through the opening and lower yourself into the room.

bathroom
You are in a bathroom, there is a claw-foot bath, one window and a basin. It is dark outside. The room is very dim, the moon giving just enough light to see. A mirror is fixed to the wall. The exit is to the south.

You can see a window and a brass lantern here.

The Girl

>take lantern
You pick up the brass lantern.

The Girl

>put lamp oil in brass lantern
You can't see any such thing.

The Girl

>turn lantern on
You flick the spark wheel but the wick does not light. The lantern needs fuel.

The Girl

>s
Darkness
It is pitch dark, and you can't see a thing.

The Girl

>down
Frightened and shaking, you go down the stairs...

press a key to continue...

(as Otto) You reach the top of the stairs. Through an open bedroom door you see a doorway leading to a loft: a broken chair and cut bonds inside. You dash into the loft...

Loft
You are in what looks like a loft, crates and boxes stacked against the walls. Wooden floors and white walls surround you. The ceiling rafters are visible. There is a single window. There is a door to the west.

A broken chair and cut rope lies on the floor.

Otto

>z
Time passes.

The loft door slams shut behind you!

Otto

>w
(first opening the loft door)

Bedroom
A small bedroom furnished with a mattress on the floor and a curtain against one wall. The loft is back to the east, another door is due south.

You can see a sheet here.

Otto

>open bedroom door
Someone has locked the bedroom door!

Otto

>shoot bedroom door
You fire two rounds into the lock of the door, it breaks open.

Otto

>s
A chilling scream echos from down below. You run down the stairs as fast as you can...

press a key to continue...

(as Tad) The room is very dim, all of them are, in hell. You have been hiding from the Demons that hunt you. Everywhere you go, they follow. Angry nasty demons that want your flesh. You managed to trap one of them, now locked in the attic.

Kitchen
In the pale light you see a bare kitchen: scuffed wooden floors, a table and some cupboards fixed to the wall. There is a door to the west.

You can see a kitchen table (on which are some sharp knives) here.

Tad

>z
Time passes.

Tad

>z
Time passes.

Tad

>z
Time passes.

You hear breaking glass. The Demon! You must stop it, before it comes for your flesh.

You unlock the kitchen door.

Tad

>take knife
You pick up a sharp cleaver from the pile of knives.

Tad

>w
You prepare to meet the horror, and pass through the door...

press a key to continue...

(as The Girl) You reach to bottom of the stairs, breathless and shaking.

Darkness
It is pitch dark, and you can't see a thing.

The Girl

>s
The kitchen door opens, a shape moves out from the shadow. You see the killer, moving towards you with a knife. You scream.

Tad moves closer to you, a cleaver in his hand...

The Girl

>z
Time passes.

Tad moves closer to you, a cleaver in his hand...

The Girl

>z
Time passes.

Tad moves closer to you, a cleaver in his hand...

The Girl

>z
Time passes.

Tad moves closer to you, a cleaver in his hand...

You close your eyes.

press a key to continue...

Living room
(as The Girl) A door to the south leads to the parlour, another to the east. You are on the stairs.

You can see Otto and Tad here.

Living room
(as Otto) A door to the south leads to the parlour, another to the east. You are on the stairs.

You can see Tad and The Girl here.

Otto

>shoot killer
You aim your pistol at the killer, exhale and squeeze the trigger...

press a key to continue...

(as Tad) You enter the Living room, the Demon is here. It is mocking you, calling out for your flesh. The parlour is due south, the kitchen to the east. Stairs go up to the second floor.

Living room
(as Tad) A door to the south leads to the parlour, another to the east. You are on the stairs.

You can see a Demon here.

Tad

>attack demon
Another demon appears behind you, swiping at you with razor claws, tearing the skin from your back.

You crumple to the floor in a bloody mess, sobbing, bleeding out.

press a key to continue...

(as Otto) For a moment you stand lifeless, making sense of the scene. The Girl collapses to the floor. You have to get her out of here.

Living room
The room is dim and nothing you see makes sense. A door leads to the east, and some stairs go up to the second floor.

You can see Otto, The Girl and a Demon here.

Living room
The room is dim and nothing you see makes sense. A door leads to the east, and some stairs go up to the second floor.

You can see Tad and The Girl here.

Otto

>pick up the girl
You lift her up.

Otto

>s
You carry the girl outside, the cool night air promising peace. You hear sirens wailing over the hill.

    *** THE DAILY NEWS
Last night Victoria Cote was found safe in an abandoned house in an undisclosed location. Her family is relieved to have her back. Detective Otto York was first on the location to ensure her safety. The family and police declined to release further details at this time. ***

Would you like to RESTART, RESTORE a saved game, QUIT or UNDO the last command?

* * *

>w
(first opening the loft door)

Bedroom
A small bedroom furnished with a mattress on the floor and a curtain against one wall. The loft is back to the east, another door is due south.

You can see a sheet here.

Otto

>open curtain
You pull the curtain open, there is a window behind it. Near the floor are some pipes.

Someone has tied a bed sheet to the pipes, and hung the other end out the window.

Otto

>climb out window
You grab the sheet and climb through the window.

Hanging outside the third floor
You are hanging outside the third storey window, gripping the bed sheet tied inside the room. You can go down.

Otto

>go down
Lowering yourself down, one handful at a time, you reach the end of the sheet.

Hanging outside the second floor
You are hanging outside a window. You are at the end of the sheet, and cannot go down any more.

You can see a window here.

Otto

>climb through window
You manage to squeeze your way through the broken frame, which is not that large for a man of your build. You cut your forearm badly. A chilling scream echos from down below right before you dash out the bathroom and down the stairs...

press a key to continue...

(as Tad) The room is very dim, all of them are, in hell. You have been hiding from the Demons that hunt you. Everywhere you go, they follow. Angry nasty demons that want your flesh. You managed to trap one of them, now locked in the attic.

Kitchen
In the pale light you see a bare kitchen: scuffed wooden floors, a table and some cupboards fixed to the wall. There is a door to the west.

You can see a kitchen table (on which are some sharp knives) here.

Tad

>z
Time passes.

Tad

* * *

>z
Time passes.

Tad moves closer to you, a cleaver in his hand...

The Girl

>z
Time passes.

Tad moves closer to you, a cleaver in his hand...

There is movement to your right, a detective on the stairs! They aim their gun at the killer with a bloodied, shaking arm. The gun fires...

press a key to continue...

Living room
(as The Girl) A door to the south leads to the parlour, another to the east. You are on the stairs.

You can see Otto and Tad here.

The shot missed! The killer turns to the detective. Now is your chance!

Living room
(as The Girl) A door to the south leads to the parlour, another to the east. You are on the stairs.

You can see Tad and Otto here.

The Girl

>attack killer
You slip the craft knife into your palm, scared to death, your limbs seem to move on their on volition. You slash at the killer's neck, blood gushes out. More blood than you ever saw.

press a key to continue...

(as Tad) You enter the Living room, the Demon is here. It is mocking you, calling out for your flesh. The parlour is due south, the kitchen to the east. Stairs go up to the second floor.

Living room
(as Tad) A door to the south leads to the parlour, another to the east. You are on the stairs.

You can see a Demon here.

Tad

>attack demon
Another demon appears behind you, swiping at you with razor claws, and misses by a small miracle. You turn to face it, ready to cut it's throat. You realize your mistake the second you feel sharp claws slashing through your neck, and again, and again.

You crumple to the floor in a bloody mess, sobbing, bleeding out.

press a key to continue...

(as Otto) For a moment you stand lifeless, making sense of the scene. The Girl collapses to the floor. You have to get her out of here.

Living room
The room is dim and nothing you see makes sense. A door leads to the east, and some stairs go up to the second floor.

You can see Otto, The Girl and a Demon here.

Living room
The room is dim and nothing you see makes sense. A door leads to the east, and some stairs go up to the second floor.

You can see Tad and The Girl here.

Otto

>pick up the girl
You lift her up.

Otto

* * *

>x self
You are wearing black jeans, a light blue collared shirt and a leather jacket. A gun holster is strapped underneath around your shoulder, a badge is attached to your belt.

Otto

>x house
Shabby and derelict.

Earlier today, an anonymous tip was called in at the homicide office. All they gave was a name, in connection with the missing girl.

Otto

>x walkway
It is aged and weathered.

The name led to outdated property records, and those led to this address. I had to get here quick, even if my partner was an hour away in the other direction. I had to.

Otto

>x badge
A silver badge attached to your belt, with words embossed on the front, Detective Otto York. Homicide.

This place is derelict, remote and dreary. The perfect place to hide an abducted girl. Never have I wanted something so dismal to be so true. I pray she is alive.

Otto

>x gun
A Glock 9mm, standard issue.

Otto

>x torch
A high-powered tactical torch.

The torch is currently switched off.

Otto

>switch torch on
You don't need it right now.

Otto

>x door
A solid wood door with a knocker fixed on the front.

Otto

>x knocker
A tarnished bronze knocker, the part fixed to the door is shaped like a cat's head. The hinged part that of a rat, hanging by it's tail from the cat's mouth.

Otto

>x rat
A tarnished bronze knocker, the part fixed to the door is shaped like a cat's head. The hinged part that of a rat, hanging by it's tail from the cat's mouth.

Otto

>open door
You grasp the oval shaped metal door knob, with a firm grip you twist it back and forth. Locked.

Otto

>knock on door
This building is marked under abandonment, you don't need to knock or have a warrant to enter. Plus you want to avoid making your presence known to anybody inside. Stopping the perpetrator is your priority. Finding the girl safe, even more so.

Otto

>kick door
This door may be old, but it is too solid to break down.

Otto

>x floor
It is aged and weathered.

Otto

>s
You walk down the porch, and around to the south side of the house.

Porch
The rough wood of the porch is weathered and stripped of varnish. There are two windows here. The porch continues west. The front door is back to the north.

Otto

>x windows
Murky and dark, you can only make out the shapes of a table and some chairs. It looks like a parlour.

Otto

>open windows
These windows are not supposed to open.

Otto

>shoot windows
You prefer finding a less noisy way inside.

Otto

>w
You walk along the porch to the west side of the house.

Rear of the house
The back of the house is no less weathered. There is a bay window here.

Otto

>x house
The rear of a shabby derelict house

Otto

>x window
It is divided into four panes of glass, and sits about chest-height.

Otto

>open window
You pull on the window frame, rust crumbles between the hinges. It swings open.

Otto

>climb in window
Looking to make sure the room is empty, you slip inside.

Parlour
A large carpet covers the floor. A low and wide table dominates the room, tattered armchairs guarding it. A silver serving dish is on the table. A bay window is to the west, a door to the north.

Otto

>x carpet
It's once-floral pattern, now faded by time and memory, reminds you of a muddy lily pond.

Otto

>x floor
It's once-floral pattern, now faded by time and memory, reminds you of a muddy lily pond.

Otto

>x table
A dark wood table with Flemish scroll style legs.

Otto

>x legs
The legs have scrolls at the top and bottom, spiralling in opposite directions. It must be hand carved.

Otto

>x window
It is divided into four panes of glass, and sits about chest-height.

Otto

>x chairs
Torn and tattered, the floor looks more inviting.

Otto

>sit in chairs
You did not come here for the holiday.

Otto

>x dish
An undecorated silver dish, tarnished with age. A lid covers it.

Otto

>open dish
Despite this silly act of curiosity, you have to see what is on the dish. You have to be sure. You lift the lid to reveal bone fragments.

Otto

>open dish
There is no need to relive that moment all over again.

Otto

>close dish
You decide to leave the dish alone. It is evidence.

Otto

>x bone fragments
These are his trophies. You are now convinced this is, the right place.

Otto

>take bones
No, they can be taken into evidence later. Time matters.

Otto

>n
(first opening the living room door)
You open the door as silently possible.

Living room
An old couch rests against a wall, a painting hangs above it. A writing desk squats in one corner, and a serving trolley in the other. A door to the south leads back to the Parlour, another leads to the east. Stairs go up to the second floor.

Otto

>x couch
A musty antiquated thing, likely a housing for many unseen critters.

Otto

>look under couch
You find nothing of interest.

Otto

>sit on couch
And risk all the lice and bedbugs living in it?

Otto

>x painting
It depicts four horsemen riding through the sky, rolling clouds behind them. On the earth below, soldiers and slaves alike engage in a battle frenzy. You recognize the horsemen by name: Conquest, War, Famine and Death.

Otto

>x horsemen
Conquest wears fine clothes, wields a longbow and a crown adorns his head. War is swinging a two-handed broad sword. Famine holds a sling, dressed in rags and looking fierce. The skeleton that is Death grips a long staff, his gaze causing recoil in those who it falls upon.

Otto

>x clouds
The clouds in the painting seem in turmoil, blocking out the entirety of the sky, except for one small patch in the heavens above, occupied by a lonesome white lamb.

Otto

>x lamb
It watches the scene below with quiet indifference.

Otto

>x slaves
The soldiers and slaves are in the middle of a massive battle. It does not seem they can tell friend apart from foe.

Otto

>x writing desk
A squat dark wood desk. You notice engravings on it's surface.

Otto

>x engravings
Names carved into the varnished wood. You read: Annette Faith Parker. Meghan Mcclure. Jami Berg. All previous victims.

Otto

>x trolley
An rickety looking thing slanted to one side: two of the wheels are missing. It has a teapot and some teacups on it.

Otto

>x teacups
Pale white tea cups without any designs.

Otto

>x teapot
A white ceramic teapot with a decorative design painted on: green leaves with violet and magenta orchid blooms. The handle in the shape of butterfly wings.

Otto

>open teapot
Lifting the butterfly lid, a business card is revealed inside the teapot.

Otto

>push trolley
It is broken and refuses to move.

Otto

>take business card
You pick up the business card.

Otto

>open kitchen door
The kitchen door is locked.

Otto

>go up
You peer up the staircase, making sure nobody else is watching from above, and cautiously ascend the stairs.

press a key to continue...

(as The Girl) Your eyes flutter open.

Bedroom
A small bedroom furnished with a mattress on the floor and a curtain against one wall. The loft is back to the east, another door is due south.

On the mattress is a sheet.

The Girl

* * *

>x mattress
A single sized mattress lies on the floor.

On the mattress is a sheet.

The Girl

>look under mattress
You find nothing of interest.

The Girl

>x curtain
Filthy and eaten by fish moths. It is drawn closed.

The Girl

>s
(first opening the bedroom door)
The bedroom door is locked.

The Girl

>kick door
(the bedroom door)
You bash at the door.

The Girl

>x pipes
You can't see any such thing.

The Girl

>x window
The window is covered by the curtain.

The Girl

>open curtain
You pull the curtain open, there is a window behind it. Near the floor are some pipes.

The Girl

>x pipes
They are painted the same as the faded white walls. You guess they carry water.

The Girl

>pull curtain open
I only understood you as far as wanting to pull the curtain.

The Girl

>pull curtain
It is already pulled open.

The Girl

>take sheet
You pick up the sheet.

The Girl

>x window
You see grass down below, no other houses are visible. You are on a second storey floor.

The Girl

>tie sheet to pipes
You open the window.

You wrap one end of the sheet around the pipes and make a knot. You drop the other end of the sheet out the window.

The Girl

* * *

>switch torch on
A bright beam flows out of your torch.

Second Floor
You are in the second floor hallway. Here are stairs that lead up to the third floor, protected by a security gate. You can go back down to the first floor. You see doors to the north, east and south.

Otto

>x stairs
A flight of wooden stairs, they lead up and down.

Otto

>x gate
It is a swing gate made of metal bars.

Otto

>n
bathroom
You are in a bathroom, there is a claw-foot bath, one window and a basin. It is dark outside. The room is very dim, the moon giving just enough light to see. A mirror is fixed to the wall. The exit is to the south.

You can see a window and a brass lantern here.

Otto

>x lantern
A brass lantern with a spark wheel fixed next to the wick.

The brass lantern is currently switched off.

Otto

>take lantern
You don't need a lantern, you have a torch.

Otto

>x bath
A stained white claw-foot bath. The feet are metal and have decorative faces moulded into them.

Otto

>x faces
You do not recognize the moulded faces.

Otto

>get in bath
Taking a bath at this point is utterly ridiculous.

Otto

>x window
The window is shoulder height, it leads to the outside.

Otto

>open window
It won't open. It must be secured permanently.

Otto

>x basin
A simple pedestal basin of white ceramic.

Otto

>x mirror
A rectangular mirror without any frame. The edges of the glass are stained.

Otto

>look in mirror
You look at yourself in the mirror: A determined gentleman with droopy violet eyes and thin eyebrows. Your brown hair is worn in a style that reminds you of a river.

Otto

>s
Second Floor
You are in the second floor hallway. Here are stairs that lead up to the third floor, protected by a security gate. You can go back down to the first floor. You see doors to the north, east and south.

Otto

>e
Bedroom
This room is bare, save for some dust covering the floor. There is one lonely window.

Otto

>x window
You see grass down below, no other houses are visible. You are on a second storey floor.

Otto

>x floor
You can't see any such thing.

Otto

>open window
You can't seem to open the window.

Otto

>w
Second Floor
You are in the second floor hallway. Here are stairs that lead up to the third floor, protected by a security gate. You can go back down to the first floor. You see doors to the north, east and south.

Otto

>s
Bedroom
The bedroom is somewhat furnished, a mattress on the floor serves as a bed, a bedside table next to it. The window is covered with a sheet. There is something under the table.

You can see a second-mattress here.

Otto

>x mattress
A single mattress on the floor.

Otto

>look under mattress
You find nothing of interest.

Otto

>x table
A low bedside table, some newspapers are on it.

Otto

>x newspaper
These are fairly recent, somebody is living here.

Otto

>take newspaper
You don't want the newspapers.

Otto

>x window
It is covered by a sheet.

Otto

>open window
You can't seem to open the window.

Otto

>x sheet
A dirty and torn sheet covers the window.

Otto

>open sheet
You would rather not waste the time, you know what is outside the window.

Otto

>n
Second Floor
You are in the second floor hallway. Here are stairs that lead up to the third floor, protected by a security gate. You can go back down to the first floor. You see doors to the north, east and south.

Otto

>open gate
the security gate is locked.

Otto

>purloin bronze key
[Purloined.]

Otto

>unlock gate with key
You unlock the security gate.

Otto

>go up stairs
You open the security gate.

You ascend the stairs, continuing your search...

press a key to continue...

(as The Girl) You hold tight to the bed sheet as you climb through the window. You hear a noise coming from the other side of the bedroom door, fear rises up inside. You pull the curtain closed, hoping to hide your escape attempt.

Waiting Room
You can see your former self here.

Hanging outside the third floor
You are hanging outside the third storey window, gripping the bed sheet tied inside the room. You can go down.

The Girl

* * *

>open sheet
You would rather not waste the time, you know what is outside the window.

Otto

>look under table
You see a safe under the table.

Otto

>x safe
A small gun safe with an electronic keypad.

Otto

>x keypad
An electronic pad for entering a code. You can ENTER 0000 to unlock the safe.

Otto

>purloin business card
[Purloined.]

Otto

>x card
"Unholy Battle pest control, Tad Kemp". You notice an impression like writing on the back of the card.

Otto

>x back of card
You can't see any such thing.

Otto

>turn card over
I only understood you as far as wanting to turn the business card.

Otto

>turn card
The back of the card has 6375 written on it.

Otto

>enter 6375
(in the keypad)
Click. The safe door creaks open.

Otto

>x safe
A small gun safe with an electronic keypad.

In the safe is a bronze key.

Otto

>take bronze key
You pick up the bronze key.

Otto

* * *

>n
Second Floor
You are in the second floor hallway. Here are stairs that lead up to the third floor, protected by a security gate. You can go back down to the first floor. You see doors to the north, east and south.

Otto

>unlock gate
What do you want to unlock the security gate with?

Otto

>unlock gate with bronze key
You unlock the security gate.

Otto

>go up stairs
You open the security gate.

You ascend the stairs, continuing your search...

press a key to continue...

(as The Girl) You hold tight to the bed sheet as you climb through the window. You hear a noise coming from the other side of the bedroom door, fear rises up inside. You pull the curtain closed, hoping to hide your escape attempt.

Waiting Room
You can see your former self here.

Hanging outside the third floor
You are hanging outside the third storey window, gripping the bed sheet tied inside the room. You can go down.

The Girl

* * *

>climb in window
You won't dare go back into that room, not with somebody just outside the door.

The Girl

>x window
You are hanging outside the window

The Girl

>close window
The window cannot close, the tied sheet prevents that.

The Girl

>listen
You hear nothing unexpected.

The Girl

>go down
Lowering yourself down, one handful at a time, you reach the end of the sheet.

Hanging outside the second floor
You are hanging outside a window. You are at the end of the sheet, and cannot go down any more.

You can see a window here.

The Girl

>x window
A chipped white frame with murky glass panes.

The Girl

>x sheet
You are hanging on to the sheet for dear life.

The Girl

>go up
You refuse to climb back up.

The Girl

>open window
You struggle to open the window, maybe a little force is called for.

The Girl

>hit window
You kick the window and shatter the glass pane. You should be able to fit through it.

The Girl

>climb through window
You raise your legs through the opening and lower yourself into the room.

bathroom
You are in a bathroom, there is a claw-foot bath, one window and a basin. A mirror is fixed to the wall. The exit is to the south.

You can see a window and a brass lantern here.

The Girl

>take lantern
You pick up the brass lantern.

The Girl

>x lantern
A brass lantern with a spark wheel fixed next to the wick.

The brass lantern is currently switched off.

The Girl

>turn lantern on
You flick the spark wheel but the wick does not light. The lantern needs fuel.

The Girl

>x bath
A stained white claw-foot bath. The feet are metal and have decorative faces moulded into them.

The Girl

>x mirror
A rectangular mirror without any frame. The edges of the glass are stained.

The Girl

>look in mirror
You look at yourself in the mirror: Big orange eyes stare back at you. Your straight brown hair is tangled about your face. You look like hell.

The Girl

>s
Second Floor
You are in the second floor hallway. Here are stairs that lead up to the third floor, protected by a security gate. You can go back down to the first floor. You see doors to the north, east and south.

The Girl

>s
You feel the urgent need to get out of here, quick. You don't want to find out who is in those rooms!

The Girl

>e
You feel the urgent need to get out of here, quick. You don't want to find out who is in those rooms!

The Girl

>n
You feel the urgent need to get out of here, quick. You don't want to find out who is in those rooms!

The Girl

>go up
You feel the urgent need to get out of here, quick. You don't want to find out who is in those rooms!

The Girl

>go down
Frightened and shaking, you go down the stairs...

press a key to continue...

(as Otto) You reach the top of the stairs, an open bedroom door in front of you. Stepping inside, you see a doorway leading to a loft: a broken chair and cut bonds inside. You dash into the loft...

Loft
You are in what looks like a loft, crates and boxes stacked against the walls. Wooden floors and white walls surround you. The ceiling rafters are visible. There is a single window. There is a door to the west.

A broken chair and cut rope lies on the floor.

Otto

* * *

>w
Hang on, you just got here.

Otto

>z
Time passes.

The loft door slams shut behind you!

Otto

>x chair
Some of the legs are snapped off.

Otto

>x ropes
They are bound around your hands and feet, fixing you to the chair.They are cut to pieces.

Otto

>take rope
You don't need cut ropes.

Otto

>w
(first opening the loft door)

Bedroom
A small bedroom furnished with a mattress on the floor and a curtain against one wall. The loft is back to the east, another door is due south.

On the mattress is a sheet.

Otto

>s
Someone has locked the bedroom door!

Otto

>kick door
(the bedroom door)
You fire two rounds into the lock of the door, it breaks open.

Otto

>go s
A chilling scream echos from down below. You run down the stairs as fast as you can...

press a key to continue...

(as Tad) The room is very dim, all of them are, in hell. You have been hiding from the Demons that hunt you. Everywhere you go, they follow. Angry nasty demons that want your flesh. You managed to trap one of them, now locked in the attic.

Kitchen
In the pale light you see a bare kitchen: scuffed wooden floors, a table and some cupboards fixed to the wall. There is a door to the west.

You can see a kitchen table (on which are some sharp knives) here.

Tad

>z
Time passes.

Tad

* * *

>take knife
You pick up a sharp cleaver from the pile of knives.

Tad

>w
You prepare to meet the horror, and pass through the door...

press a key to continue...

(as The Girl) You reach to bottom of the stairs, breathless and shaking.

Living room
The room is dim and nothing you see makes sense. There are doors to the south and east.

The Girl

>s
The kitchen door opens, a shape moves out from the shadow. You see the killer, moving towards you with a knife. You scream.

Tad moves closer to you, a cleaver in his hand...

The Girl

* * *

>shoot killer
You aim your pistol at the killer, exhale and squeeze the trigger...

press a key to continue...

(as Tad) You enter the Living room, the Demon is here. It is mocking you, calling out for your flesh. The parlour is due south, the kitchen to the east. Stairs go up to the second floor.

Living room
(as Tad) A door to the south leads to the parlour, another to the east. You are on the stairs.

You can see a Demon here.

Tad

>x demon
It has the figure of a man with leather-like skin, it has no use for clothes. The knees bend backwards, six razor talons extend where fingers would be. Sharp fangs fill the mouth, a bald head is adorned with two goat-like horns.

Tad

>kill demon
Another demon appears behind you, swiping at you with razor claws, tearing the skin from your back.

You crumple to the floor in a bloody mess, sobbing, bleeding out.

press a key to continue...

(as Otto) For a moment you stand lifeless, making sense of the scene. The Girl collapses to the floor. You have to get her out of here.

Living room
The room is dim and nothing you see makes sense. A door leads to the east, and some stairs go up to the second floor.

You can see Otto, The Girl and a Demon here.

Living room
The room is dim and nothing you see makes sense. A door leads to the east, and some stairs go up to the second floor.

You can see Tad and The Girl here.

Otto

>pick up girl
You lift her up.

Otto

>s
You carry the girl outside, the cool night air promising peace. You hear sirens wailing over the hill.

    *** THE DAILY NEWS
Last night Victoria Cote was found safe in an abandoned house in an undisclosed location. Her family is relieved to have her back. Detective Otto York was first on the location to ensure her safety. The family and police declined to release further details at this time. ***

Would you like to RESTART, RESTORE a saved game, QUIT or UNDO the last command?

* * *

>s
Someone has locked the bedroom door!

Otto

>open curtain
You pull the curtain open, there is a window behind it. Near the floor are some pipes.

Someone has tied a bed sheet to the pipes, and hung the other end out the window.

Otto

>take sheet
The sheet is tied to the pipes. You can't take it.

Otto

>untie sheet
You can't untie that.

Otto

>climb out window
You grab the sheet and climb through the window.

Hanging outside the third floor
You are hanging outside the third storey window, gripping the bed sheet tied inside the room. You can go down.

Otto

>climb out window
You are wasting time. You can't back out with your choice now.

Otto

>x sheet
You are hanging on to the sheet for dear life.

Otto

>go down
Lowering yourself down, one handful at a time, you reach the end of the sheet.

Hanging outside the second floor
You are hanging outside a window. You are at the end of the sheet, and cannot go down any more.

You can see a window here.

Otto

>open window
It won't open, but the glass panes are broken away. You can climb through it.

Otto

>climb through window
You manage to squeeze your way through the broken frame, which is not that large for a man of your build. You cut your forearm badly. A chilling scream echos from down below right before you dash out the bathroom and down the stairs...

press a key to continue...

(as Tad) The room is very dim, all of them are, in hell. You have been hiding from the Demons that hunt you. Everywhere you go, they follow. Angry nasty demons that want your flesh. You managed to trap one of them, now locked in the attic.

Kitchen
In the pale light you see a bare kitchen: scuffed wooden floors, a table and some cupboards fixed to the wall. There is a door to the west.

You can see a kitchen table (on which are some sharp knives) here.

Tad

* * *

>attack killer
You slip the craft knife into your palm, scared to death, your limbs seem to move on their on volition. You slash at the killer's neck, blood gushes out. More blood than you ever saw.

press a key to continue...

(as Tad) You enter the Living room, the Demon is here. It is mocking you, calling out for your flesh. The parlour is due south, the kitchen to the east. Stairs go up to the second floor.

Living room
(as Tad) A door to the south leads to the parlour, another to the east. You are on the stairs.

You can see a Demon here.

Tad

>z
Time passes.

Tad

>x demon
It has the figure of a man with leather-like skin, it has no use for clothes. The knees bend backwards, six razor talons extend where fingers would be. Sharp fangs fill the mouth, a bald head is adorned with two goat-like horns.

Tad

>attack demon
Another demon appears behind you, swiping at you with razor claws, and misses by a small miracle. You turn to face it, ready to cut it's throat. You realize your mistake the second you feel sharp claws slashing through your neck, and again, and again.

You crumple to the floor in a bloody mess, sobbing, bleeding out.

press a key to continue...

(as Otto) For a moment you stand lifeless, making sense of the scene. The Girl collapses to the floor. You have to get her out of here.

Living room
The room is dim and nothing you see makes sense. A door leads to the east, and some stairs go up to the second floor.

You can see Otto, The Girl and a Demon here.

Living room
The room is dim and nothing you see makes sense. A door leads to the east, and some stairs go up to the second floor.

You can see Tad and The Girl here.

Otto

>s
You can't leave the girl lying here.

Otto

>pick up girl
You lift her up.

Otto

* * *

>test cracksafe
(Testing.)

Otto > [1] turn torch on
A bright beam flows out of your torch.

Second Floor
You are in the second floor hallway. Here are stairs that lead up to the third floor, protected by a security gate. You can go back down to the first floor. You see doors to the north, east and south.

Otto > [2] s

Bedroom
The bedroom is somewhat furnished, a mattress on the floor serves as a bed, a bedside table next to it. The window is covered with a sheet.

You can see a second-mattress here.

Otto

>x safe
A small gun safe with an electronic keypad.

Otto

>x keypad
An electronic pad for entering a number code. You can ENTER 0000 to unlock the safe.

Otto

>press 4
You can't see any such thing.

Otto

>press digit 4
You can't see any such thing.

Otto

>push digit
You can't see any such thing.

Otto

>press reset
You can't see any such thing.

Otto

>press digit reset
You can't see any such thing.

Otto

>press digit 10
You can't see any such thing.

Otto

>press digit foo
You can't see any such thing.

Otto

>press digit #
You can't see any such thing.

Otto

>x buttons
You can't see any such thing.

Otto

>x digits
You can't see any such thing.

Otto

>push digit
You can't see any such thing.

Otto

>push digit 3
You can't see any such thing.

Otto

>press digit 5
You can't see any such thing.

Otto

>showme keypad
keypad - thing
location: part of the safe in Bedroom
singular-named, improper-named; unlit, inedible, portable
list grouping key: none
printed name: "keypad"
printed plural name: none
indefinite article: none
description: "An electronic pad with ten digits on it, zero to nine, including a "reset" digit."
initial appearance: none

Otto

* * *

>x keypad
An electronic pad for entering a number code. You can ENTER 0000 to unlock the safe.

Otto

>enter 0000 in keypad
The safe beeps in error.

Otto

>enter 0000 in keypad
The safe beeps in error.

Otto

>enter 1234 in keypad
The safe beeps in error.

Otto

>enter 6375 in keypad
Click. The safe door creaks open.

Otto

>x safe
A small gun safe with an electronic keypad.

In the safe is a bronze key.

Otto

>take key
You pick up the bronze key.

Otto

>x key
A short but fat bronze key, it has decorative grape vines embossed around the shaft and the head.

Otto

>enter 1234
(in the keypad)
The safe is already open.

Otto

>n
Second Floor
You are in the second floor hallway. Here are stairs that lead up to the third floor, protected by a security gate. You can go back down to the first floor. You see doors to the north, east and south.

Otto

>enter 123
You can't see any such thing.

Otto

>s
Bedroom
The bedroom is somewhat furnished, a mattress on the floor serves as a bed, a bedside table next to it. The window is covered with a sheet.

You can see a second-mattress here.

Otto

>enter 344
(in the keypad)
The safe is already open.

Otto

>close safe
You close the safe.

Otto

>open safe
The safe is locked.

Otto

>enter 1234
(in the keypad)
The safe beeps in error.

Otto

>enter 6375
(in the keypad)
Click. The safe door creaks open.

Otto

>x safe
A small gun safe with an electronic keypad.

Otto

>x safe
A small gun safe with an electronic keypad.

Otto

* * *

>test cracksafe
(Testing.)

Otto > [1] turn torch on
A bright beam flows out of your torch.

Second Floor
You are in the second floor hallway. Here are stairs that lead up to the third floor, protected by a security gate. You can go back down to the first floor. You see doors to the north, east and south.

Otto > [2] s

Bedroom
The bedroom is somewhat furnished, a mattress on the floor serves as a bed, a bedside table next to it. The window is covered with a sheet.

You can see a second-mattress here.

Otto

>look under table
You see a safe under the table.

Otto

* * *

>x keypad
An electronic pad for entering a code. You can ENTER 0000 to unlock the safe.

Otto

>open safe
The safe is locked.

Otto

>enter 1111
(in the keypad)
The safe beeps in error.

Otto

>enter 6375
(in the keypad)
Click. The safe door creaks open.

Otto

>look in safe
In the safe is a bronze key.

Otto

* * *

>s
The kitchen door opens, a shape moves out from the shadow. You see the killer, moving towards you with a knife. You scream.

Tad moves closer to you, a cleaver in his hand...

The Girl

>w
You walk along the porch to the west side of the house.

Rear of the house
The back of the house is no less weathered. There is a bay window here.

Earlier today, an anonymous tip was called in at the homicide office. All they gave was a name, in connection with the missing girl.

Otto

>open window
You pull on the window frame, rust crumbles between the hinges. It swings open.

The name led to outdated property records, and those led to this address. I had to get here quick, even if my partner was an hour away in the other direction. I had to.

Otto

>enter window
Looking to make sure the room is empty, you slip inside.

Parlour
A large carpet covers the floor. A low and wide table dominates the room, tattered armchairs guarding it. A silver serving dish is on the table. A bay window is to the west, a door to the north.

This place is derelict, remote and dreary. The perfect place to hide an abducted girl. Never have I wanted something so dismal to be so true. I pray she is alive.

Otto

>n
(first opening the living room door)
You open the door as silently possible.

Living room
An old couch rests against a wall, a painting hangs above it. A writing desk squats in one corner, and a serving trolley in the other. A door to the south leads back to the Parlour, another leads to the east. Stairs go up to the second floor.

Otto

>x stairs
A flight of wooden stairs that lead up.

Otto

>go up stairs
You peer up the staircase, making sure nobody else is watching from above, and cautiously ascend the stairs.

press a key to continue...

* * *

>z
Time passes.

Tad moves closer to you, a cleaver in his hand...

The Girl

>z
Time passes.

Tad moves closer to you, a cleaver in his hand...

There is movement to your right, a detective on the stairs! They aim their gun at the killer with a bloodied, shaking arm. The gun fires...

press a key to continue...

Living room
The room is dim and nothing you see makes sense. There are doors to the south and east.

You can see Otto and Tad here.

The shot missed! The killer turns to the detective. Now is your chance!

The Girl

>cut killer with knife
You can't see any such thing.

The Girl

>puloin craft knife
I didn't understand that sentence.

The Girl

>purloin craft knife
[Purloined.]

The Girl

>cut killer with knife
You slip the craft knife into your palm, scared to death, your limbs seem to move on their on volition. You slash at the killer's neck, blood gushes out. More blood than you ever saw.

press a key to continue...

(as Tad) You enter the Living room, the Demon is here. It is mocking you, calling out for your flesh. The parlour is due south, the kitchen to the east. Stairs go up to the second floor.

Living room
The room is dim and nothing you see makes sense. There are doors to the south and east.

You can see a Demon here.

Tad

* * *

>turn torch on
A bright beam flows out of your torch.

Second Floor
You are in the second floor hallway. Here are stairs that lead up to the third floor, protected by a security gate. You can go back down to the first floor. You see doors to the north, east and south.

Otto

>n
bathroom
You are in a bathroom, there is a claw-foot bath, one window and a basin. It is dark outside. The room is very dim, the moon giving just enough light to see. A mirror is fixed to the wall. The exit is to the south.

You can see a brass lantern here.

Otto

>open window
It won't open. It must be secured permanently.

Otto

>x window
The window is shoulder height, it leads to the outside.

Otto

>x feet
Moulded faces make up the feet of the bathtub.

Otto

>break mirror
On second thought, you don't think that is a good idea.

Otto

>s
Second Floor
You are in the second floor hallway. Here are stairs that lead up to the third floor, protected by a security gate. You can go back down to the first floor. You see doors to the north, east and south.

Otto

>s
Bedroom
The bedroom is somewhat furnished, a mattress on the floor serves as a bed, a bedside table next to it. The window is covered with a sheet. There is something under the table.

Otto

* * *

>look under table
You see a safe under the table.

Otto

>x gun safe
A small gun safe with an electronic keypad.

Otto

>x safe
A small gun safe with an electronic keypad.

Otto

>open gun safe
The gun safe is locked.

Otto

>n
Second Floor
You are in the second floor hallway. Here are stairs that lead up to the third floor, protected by a security gate. You can go back down to the first floor. You see doors to the north, east and south.

Otto

>purloin bronze key
[Purloined.]

Otto

>unlock gate with bronze
You unlock the security gate.

Otto

>up
You open the security gate.

You ascend the stairs, continuing your search...

press a key to continue...

(as The Girl) You hold tight to the bed sheet as you climb through the window. You hear a noise coming from the other side of the bedroom door, fear rises up inside. You pull the curtain closed, hoping to hide your escape attempt.

Hanging outside the third floor
You are hanging outside the third storey window, gripping the bed sheet tied inside the room. You can go down.

The Girl

I beg your pardon?

The Girl