Light pierces your vision as your eyes flutter open. Blurred shapes spin around as you shake the sound of a pounding heart free. You remember a struggle, the abduction, your name... nothing.

Deliverance
A Halloween story by Wesley Werner
Release 1 / Serial number 161101 / Inform 7 build 6M62 (I6/v6.33 lib 6/12N) SD

Loft (on the chair)
You don't know where you are, some kind of room. You feel too panicked to notice your surroundings. It is difficult to move.

The Girl

>x self
You see dirt on your bruised arms. You are wearing red jeans and a yellow blouse. Your hands are tied with ropes to the back of the chair, your feet tied to the legs of the chair.

The Girl

>i
You are tied up and cannot search your pockets.

The Girl

>get up
You try to stand up. Your hands and feet are bound to the chair with rope, and you nearly topple over. The chair creaks violently.

The Girl

* * *

>get up
You rock the chair. One one side of the chair breaks under the strain and you topple on to your side, your head almost hitting a small cardboard box. Your one arm is freed.

The Girl

>get up
You struggle to raise yourself up from this position.

The Girl

* * *

>x box
A small closed box.

The Girl

>open box
You reach for the box. As you pull it closer it falls over, craft supplies spill out in front of you - some twine, a tube of hardened glue, pots of paints, a bottle of turpentine and a craft knife.

The Girl

>take all
craft knife: You pick up the craft knife carefully, avoiding the business end of it.
bottle of turpentine: You pick up the bottle of turpentine, and drop it despite your restraints.
pots of paints: You pick up pots of paints, and drop it despite your restraints.
tube of hardened glue: You pick up the tube of hardened glue, and drop it despite your restraints.
twine: You pick up the twine, and drop it despite your restraints.
small cardboard box: You don't want the empty box.

The Girl

>x rope
They are bound around your one hand and both your feet.

The Girl

>x ropes
They are bound around your one hand and both your feet.

The Girl

>x bonds
They are bound around your one hand and both your feet.

The Girl

>cut bonds
You curl up enough to reach your legs and sever the bonds around them. You get up into a kneeling position and cut your other arm free. You stand up, wobbling.

Loft
You are in what looks like a loft, crates and boxes stacked against the walls. Wooden floors and white walls surround you. The ceiling rafters are visible. There is a single window. There is a door to the west.

A broken chair and cut rope lies on the floor.

A small cardboard box is nearby.

You can also see a bottle of turpentine, pots of paints, a tube of hardened glue and some twine here.

The Girl

>take chair
You have no need for a broken chair.

The Girl

>take rope
You don't need cut ropes.

The Girl

>take ropes
You don't need cut ropes.

The Girl

>drop knife
You want to hang on to it.

The Girl

>x self
You see dirt on your bruised arms. You are wearing red jeans and a yellow blouse. 

The Girl

>x window
A small window allows a trickle of light into the room.

The Girl

* * *

>look out window
It is too far up, you can't see through it.

The Girl

>take box
You don't want the empty box.

The Girl

>l
Loft
You are in what looks like a loft, crates and boxes stacked against the walls. Wooden floors and white walls surround you. The ceiling rafters are visible. There is a single window. There is a door to the west.

A broken chair and cut rope lies on the floor.

A small cardboard box is nearby.

You can also see a bottle of turpentine, pots of paints, a tube of hardened glue and some twine here.

The Girl

>take all
bottle of turpentine: You pick up the bottle of turpentine.
pots of paints: You don't want the paints.
tube of hardened glue: You don't need dry glue.
twine: You pick up the twine.
small cardboard box: You don't want the empty box.

The Girl

>w
(first opening the loft door)

You feel faint.

Bedroom
A small bedroom furnished with a mattress on the floor and a curtain against one wall. The loft is back to the east, another door is due south.

On the mattress are a sheet and a torch.

The Girl

>open curtain
You pull the curtain open, there is a window behind it. Near the floor are some pipes.

The room turns into a tunnel, the floor rising up to meet you. Shadows creep in from all sides as your vision fades.

press a key to continue...

>[enter]
(as Otto) The last daylight creeps away, the moon struggles to find gaps through looming clouds. A chill moves over your skin.

Front of the house
You are in front of an old house. The flaking paint and shoddy walkway indicate it's age and abandonment. The front door is here, the porch wraps around the building, towards the south. You are carrying your badge, gun and torch.

Otto

>x walkway
You can't see any such thing.

Otto

>x porch
You can't see any such thing.

Otto

>x badge
It reads: Detective Otto York. Homicide.

Otto

* * *

>x torch
A high-powered tactical torch.

The torch is currently switched off.

The name led to outdated property records, and those led to this address. Time is life, and death. I had to get here quick, even if my partner was an hour away the other direction. I had to.

Otto

>switch torch on
You don't need it right now.

This place is derelict, remote and dreary. The perfect place to hide an abducted girl. Never have I wanted something so dismal to be so true. I pray she is alive.

Otto

>x door
A solid wood door with a knocker fixed on the front.

Otto

* * *

>x knocker
A tarnished bronze knocker, the part fixed to the door is shaped like a cat's head. The hinged part that of a rat, hanging by it's tail from the cat's mouth.

Otto

>take knocker
That seems to be a part of the front door.

Otto

>knock knocker
I didn't understand that sentence.

Otto

>knock on door
This building is marked under abandonment, you don't need to knock or have a warrant to enter. Plus you want to avoid making your presence known to anybody inside. Stopping the perpetrator is your priority. Finding the girl safe, even more so.

Otto

>open door
You grasp the oval shaped metal door knob, with a firm grip you twist it back and forth. Locked.

Otto

>shoot door
This door may be old, but it is too solid to break down.

Otto

>hit door
This door may be old, but it is too solid to break down.

Otto

>s
You walk down the porch, and around to the south side of the house.

Porch
The rough wood of the porch is weathered and stripped of varnish. There are two windows here. The porch continues west. The front door is back to the north.

Otto

>e
You can't go that way.

Otto

>n
Front of the house
You are in front of an old house. The flaking paint and shoddy walkway indicate it's age and abandonment. The front door is here, the porch wraps around the building, towards the south. You are carrying your badge, gun and torch.

Otto

>s
You walk down the porch, and around to the south side of the house.

Porch
The rough wood of the porch is weathered and stripped of varnish. There are two windows here. The porch continues west. The front door is back to the north.

Otto

* * *

>open windows
These windows are not supposed to open.

Otto

>hit windows
You prefer finding a less noisy way inside.

Otto

>w
You walk along the porch to the west side of the house.

Rear of the house
The back of the house is no less weathered. There is a bay window here.

Otto

* * *

>x window
It is divided into four panes of glass, and sits about chest-height.

Otto

>x house
The rear of a shabby derelict house

Otto

>hit window
Violence isn't the answer to this one.

Otto

>open window
You pull on the window frame, rust crumbles between the hinges. It swings open.

Otto

>enter house
Looking to make sure the room is empty, you slip inside.

Parlour
A large carpet covers the floor. A low and wide table dominates the room, tattered armchairs guarding it. A silver serving dish is on the table. A bay window is to the west, a door to the north.

Otto

>x chair
Torn and tattered, the floor looks more inviting.

Otto

>sit in chair
You did not come here for the holiday.

Otto

* * *

>x carpet
It's once-floral pattern, now faded by time and memory, reminds you of a muddy lily pond.

Otto

>x dish
An undecorated silver dish, tarnished with age. A lid covers it.

Otto

>take dish
Despite this silly act of curiosity, you have to see what is on the dish. You have to be sure. You lift the lid to reveal bone fragments.

Otto

>x bones
These are his trophies. You are now convinced this is, or was, the right place.

Otto

>take bones
No, they can be taken into evidence later. Time matters.

Otto

* * *

>n
(first opening the living room door)
You open the door as silently possible.

Living room
An old couch rests against a wall, a painting hangs above it. A writing desk squats in one corner, and a serving trolley in the other. A door to the south leads back to the Parlour, another leads to the east. Stairs go up to the second floor.

Otto

>x trolley
An rickety looking thing slanted to one side: two of the wheels are missing. It has a teapot and some teacups on it.

Otto

>take teapot
You refuse to break for tea.

Otto

>x teapot
A white ceramic teapot with a decorative design painted on: green leaves with violet and magenta orchid blooms. The handle in the shape of butterfly wings.

Otto

>x desk
A squat dark wood desk. You notice engravings on it's surface.

Otto

* * *

>x engravings
Names carved into the varnished wood. You read: Annette Faith Parker. Meghan Mcclure. Jami Berg. All previous victims.

Otto

>x wheels
The two remaining wheels are discs of black plastic.

Otto

>x painting
It depicts four horsemen riding through the sky, rolling clouds behind them. On the earth below, soldiers and slaves alike engage in a battle frenzy. You recognize the horsemen by name: Conquest, War, Famine and Death.

Otto

* * *

>x lamb
It watches the scene below with quiet indifference.

Otto

>x earth
You can't see any such thing.

Otto

>x soldiers
The soldiers and slaves are in the middle of a massive battle. It does not seem they can tell friend apart from foe.

Otto

>l
Living room
An old couch rests against a wall, a painting hangs above it. A writing desk squats in one corner, and a serving trolley in the other. A door to the south leads back to the Parlour, another leads to the east. Stairs go up to the second floor.

Otto

>open teapot
Lifting the butterfly lid, a bronze key is revealed inside the teapot.

Otto

>take key
You pick up the bronze key.

Otto

>e
(first opening the kitchen door)
The kitchen door is locked.

Otto

>unlock door with key
(the kitchen door with the bronze key)
The bronze key does not fit the kitchen door lock.

Otto

>go up
You peer up the staircase, making sure nobody else is watching from above, and cautiously ascend the stairs.

press a key to continue...

>[enter]
(as The Girl) Your eyes flutter open.

Bedroom
A small bedroom furnished with a mattress on the floor and a curtain against one wall, a window behind it. Some pipes run along the wall behind the curtain. The loft is back to the east, another door is due south.

On the mattress are a sheet and a torch.

The Girl

>s
(first opening the bedroom door)
The bedroom door is locked.

The Girl

>take all
sheet: You pick up the sheet.
torch: You pick up the torch.

The Girl

>switch torch on
You don't need it right now.

The Girl

>x torch
A simple black plastic torch.

The torch is currently switched off.

The Girl

>x sheet
Pale from dirt.

The Girl

>x widnow
You can't see any such thing.

The Girl

>x window
You see grass down below, no other houses are visible. You are on a second storey floor.

The Girl

>x pipes
They are painted the same as the faded white walls. You guess they carry water.

The Girl

>open window
You open the window.

The Girl

>climb out
You must name something more substantial.

The Girl

>climb out window
It is too high up, you will surely fall. Perhaps if you had something to climb down with.

The Girl

>tie
What do you want to tie?

The Girl

>tie sheet
What do you want to tie the sheet to?

The Girl

>tie sheet to pipes
You wrap one end of the sheet around the pipes and make a knot. You drop the other end of the sheet out the window.

The Girl

>climb out window
You hold on to the makeshift rope, climb through the window and prepare yourself.

press a key to continue...

>[enter]
(as Otto) As you reach the top of the second floor, the last of the daylight vanishes. You are left in darkness.

Darkness
It is pitch dark, and you can't see a thing.

Otto

>switch torch on
A bright beam flows out of your torch.

Second Floor
You are in the second floor hallway. Here are stairs that lead up to the third floor, protected by a security gate. You can go back down to the first floor. You see doors to the north, east and south.

Otto

>go up
(first opening the security gate)
the security gate is locked.

Otto

>n
bathroom
You are in a bathroom, there is a claw-foot bath, one window and a basin. A mirror is fixed to the wall. The exit is to the south.

You can see a window here.

Otto

>x window
The window is shoulder height, it leads to the outside.

Otto

* * *

>open window
It won't open. It must be secured permanently.

Otto

>s
Second Floor
You are in the second floor hallway. Here are stairs that lead up to the third floor, protected by a security gate. You can go back down to the first floor. You see doors to the north, east and south.

Otto

* * *

>w
Second Floor
You are in the second floor hallway. Here are stairs that lead up to the third floor, protected by a security gate. You can go back down to the first floor. You see doors to the north, east and south.

Otto

>s
Bedroom
The bedroom is somewhat furnished, a mattress on the floor serves as a bed, a bedside table next to it. The window is covered with a sheet.

You can see a second-mattress here.

Otto

>x table
A low bedside table, some newspapers are on it.

Otto

* * *

>x newspaper
These are fairly recent, somebody is living here.

Otto

>n
Second Floor
You are in the second floor hallway. Here are stairs that lead up to the third floor, protected by a security gate. You can go back down to the first floor. You see doors to the north, east and south.

Otto

>unlock gate with key
You unlock the security gate.

Otto

>go up
You open the security gate.

You ascend the stairs, continuing your search...

press a key to continue...

>[enter]
(as The Girl) You hold tight to the bed sheet as you climb through the window. You hear a noise coming from the other side of the bedroom door, fear rises up inside. You pull the curtain closed, hoping to hide your escape attempt.

Waiting Room
You can see your former self here.

Hanging outside the third floor
You are hanging outside the third storey window, gripping the bed sheet tied inside the room. You can go down.

The Girl

>climb in window
You won't dare go back into that room, not with somebody just outside the door.

The Girl

* * *

>x window
You are hanging outside the window

The Girl

>enter window
You won't dare go back into that room, not with somebody just outside the door.

The Girl

>climb through window
You won't dare go back into that room, not with somebody just outside the door.

The Girl

* * *

>showme window
(the the window)
the window - thing
location: in Hanging outside the third floor
singular-named, improper-named; unlit, inedible, fixed in place, scenery
list grouping key: none
printed name: "the window"
printed plural name: none
indefinite article: none
description: "You are hanging outside the window"
initial appearance: none

The Girl

>x self
You see dirt on your bruised arms. You are wearing red jeans and a yellow blouse. 

The Girl

>go down
Lowering yourself down, one handful at a time, you reach the end of the sheet.

Hanging outside the second floor
You are hanging outside a window. You are at the end of the sheet, and cannot go down any more.

You can see a window here.

The Girl

>go up
You refuse to climb back up.

The Girl

>x window
A chipped white frame with murky glass panes.

The Girl

>open window
You struggle to open the window, maybe a little force is called for.

The Girl

* * *

>kick window
You kick the window and shatter the glass pane. You should be able to fit through it.

The Girl

>climb in window
You raise your legs through the opening and lower yourself into the room.

Darkness
It is pitch dark, and you can't see a thing.

The Girl

>switch torch on
The torch emits a warm glow, not very bright, but enough to see.

bathroom
You are in a bathroom, there is a claw-foot bath, one window and a basin. A mirror is fixed to the wall. The exit is to the south.

You can see a window here.

The Girl

>x mirro
You can't see any such thing.

The Girl

>x mirror
A rectangular mirror without any frame. The edges of the glass are stained.

The Girl

* * *

>s
Second Floor
You are in the second floor hallway. Here are stairs that lead up to the third floor, protected by a security gate. You can go back down to the first floor. You see doors to the north, east and south.

The Girl

>n
You feel the urgent need to get out of here, quick. You don't want to find out who is in those rooms!

The Girl

>e
You feel the urgent need to get out of here, quick. You don't want to find out who is in those rooms!

The Girl

>s
You feel the urgent need to get out of here, quick. You don't want to find out who is in those rooms!

The Girl

>go up
You feel the urgent need to get out of here, quick. You don't want to find out who is in those rooms!

The Girl

>go down
Frightened and shaking, you go down the stairs...

press a key to continue...

>[enter]
(as Otto) You reach the top of the stairs, an open bedroom door in front of you. Stepping inside, you see a doorway leading to a loft: a broken chair and cut bonds inside. You dash into the loft...

Loft
You are in what looks like a loft, crates and boxes stacked against the walls. Wooden floors and white walls surround you. The ceiling rafters are visible. There is a single window. There is a door to the west.

A broken chair and cut rope lies on the floor.

A small cardboard box is nearby.

You can also see pots of paints and a tube of hardened glue here.

Otto

>take all
pots of paints: You don't want the paints.
tube of hardened glue: You don't need dry glue.
small cardboard box: You don't want the empty box.

The loft door slams shut behind you!

Otto

>take chair
You have no need for a broken chair.

Otto

>w
(first opening the loft door)

Bedroom
A small bedroom furnished with a mattress on the floor and a curtain against one wall. The loft is back to the east, another door is due south.

You can see a sheet here.

Otto

>s
Someone has locked the bedroom door!

Otto

>shoot door
(the bedroom door)
You fire two rounds into the lock of the door, it breaks open.

Otto

>s
A chilling scream echos from down below. You run down the stairs as fast as you can...

press a key to continue...

>[enter]
(as Tad) The room is very dim, all of them are, in hell. You have been hiding from the Demons that hunt you. Everywhere you go, they follow. Angry nasty demons that want your flesh. You managed to trap one of them, now locked in the attic.

Kitchen
In the pale light you see a bare kitchen: scuffed wooden floors, a table and some cupboards fixed to the wall. There is a door to the west.

You can see a kitchen table (on which are some sharp knives) here.

Tad

>x floor
Scuffed wooden floors groan under your steps.

Tad

>x table
A worn and dirty table.

On the kitchen table are some sharp knives.

Tad

>x cupboard
Empty cupboards, like so many graves, are fixed to the wall. Some are missing doors, you used those for firewood.

Tad

>open cupboards
You know they have nothing in them, so you don't bother looking inside them.

You hear breaking glass. The Demon! You must stop it, before it comes for your flesh.

You unlock the kitchen door.

Tad

>w
I can't go out there without protection. I need a knife!

Tad

>take knife
You pick up a sharp cleaver from the pile of knives.

Tad

>w
You prepare to meet the horror, and pass through the door...

press a key to continue...

>[enter]
(as The Girl) You reach to bottom of the stairs, breathless and shaking.

Living room
The room is dim and nothing you see makes sense. There are doors to the south and east.

The Girl

>s
The kitchen door opens, a shape moves out from the shadow. You see the killer, moving towards you with a knife. You scream.

Tad moves closer to you, a cleaver in his hand...

The Girl

>s
You can't, you are frozen with fear!

Tad moves closer to you, a cleaver in his hand...

The Girl

>attack killer
The knife is in your pocket. You limbs frozen, you can't move while he glares at you.

Tad moves closer to you, a cleaver in his hand...

The Girl

>i
You are carrying:
  a torch (providing light)
  a sheet
  some twine
  a bottle of turpentine
  a craft knife

Tad moves closer to you, a cleaver in his hand...

You close your eyes.

press a key to continue...

>[enter]
Living room
You look past the room, and focus on who is in front of you. A door to the south leads back to the parlour, another to the east. You are on the stairs that lead up.

You can see Tad and The Girl here.

Otto

>x girl
You are wasting time!

Otto

>x tad
You are wasting time!

Otto

>z
You are wasting time!

Otto

* * *

>s
No time to run away, you must stop him!

Otto

>shoot killer
You aim your pistol at the killer,  exhale and squeeze the trigger...

press a key to continue...

>[enter]
(as Tad) You enter the Living room, the Demon is here. It is mocking you, calling out for your flesh. The parlour is due south, the kitchen to the east. Stairs go up to the second floor.

Living room
You don't care to notice anything in here, except the harbinger of death, the Demon. It mocks you, taunts you with ideas of pulling your flesh from your bones. You have to kill it.

You can see a Demon here.

Tad

>x demon
It has the figure of a man with leather-like skin, it has no use for clothes. The knees bend backwards, six razor talons extend where fingers would be. Sharp fangs fill the mouth, a bald head is adorned with two goat-like horns.

Tad

>cut demon
Another demon appears behind you, swiping at you with razor claws, tearing the skin from your back.

You crumple to the floor in a bloody mess, sobbing, bleeding out.

press a key to continue...

>[enter]
(as Otto) For a moment you stand lifeless, making sense of the scene. The Girl collapses to the floor. You have to get her out of here.

Living room
The room is dim and nothing you see makes sense. A door leads to the east, and some stairs go up to the second floor.

You can see The Girl and Tad here.

Otto

>s
You can't leave the girl lying here.

Otto

>e
That is not the way out.

Otto

>pick up girl
You lift her up.

Otto

* * *

>s
Someone has locked the bedroom door!

Otto

>x sheet
Pale from dirt.

Otto

>open curtain
You pull the curtain open, there is a window behind it. Near the floor are some pipes.

Someone has tied a bed sheet to the pipes, and hung the other end out the window.

Otto

>x sheet
Pale from dirt.

Otto

>open curtain
It is already pulled open.

Otto

>x sheet
Pale from dirt.

Otto

>take sheet
The sheet is tied to the pipes. You can't take it.

Otto

>climb out window
You grab the sheet and climb through the window.

Hanging outside the third floor
You are hanging outside the third storey window, gripping the bed sheet tied inside the room. You can go down.

Otto

* * *

>go down
Lowering yourself down, one handful at a time, you reach the end of the sheet.

Hanging outside the second floor
You are hanging outside a window. You are at the end of the sheet, and cannot go down any more.

You can see a window here.

Otto

>x window
A chipped white frame with murky glass panes.

Otto

>open window
It is broken open.

Otto

>climb in window
You manage to squeeze your way through the broken frame, which is not that large for a man of your build. You cut your shooting arm in the process. A chilling scream echos from down below. You get up, and dash down the stairs...

press a key to continue...

>[enter]
(as Tad) The room is very dim, all of them are, in hell. You have been hiding from the Demons that hunt you. Everywhere you go, they follow. Angry nasty demons that want your flesh. You managed to trap one of them, now locked in the attic.

Kitchen
In the pale light you see a bare kitchen: scuffed wooden floors, a table and some cupboards fixed to the wall. There is a door to the west.

You can see a kitchen table (on which are some sharp knives) here.

Tad

>x table
A worn and dirty table.

On the kitchen table are some sharp knives.

Tad

>z
Time passes.

Tad

* * *

>z
Time passes.

You hear breaking glass. The Demon! You must stop it, before it comes for your flesh.

You unlock the kitchen door.

Tad

>w
I can't go out there without protection. I need a knife!

Tad

* * *

>[enter]
(as The Girl) You reach to bottom of the stairs, breathless and shaking.

Living room
The room is dim and nothing you see makes sense. There are doors to the south and east.

The Girl

>z
Time passes.

The Girl

>s
The kitchen door opens, a shape moves out from the shadow. You see the killer, moving towards you with a knife. You scream.

Tad moves closer to you, a cleaver in his hand...

The Girl

>attack tad
The knife is in your pocket. You limbs frozen, you can't move while he glares at you.

Tad moves closer to you, a cleaver in his hand...

The Girl

>z
Time passes.

Tad moves closer to you, a cleaver in his hand...

The Girl

>z
Time passes.

Tad moves closer to you, a cleaver in his hand...

There is movement to your right, a detective on the stairs! They aim their gun at the killer with a bloodied, shaking arm. The gun fires.

press a key to continue...

>[enter]
The shot missed! The killer turns to the detective. Now is your chance!

Living room
You look past the room, and focus on who is in front of you. A door to the south leads back to the parlour, another to the east. You are on the stairs that lead up.

You can see Otto and Tad here.

The Girl

>z
You are wasting time!

The Girl

>x tad
You are wasting time!

The Girl

>x otto
You are wasting time!

The Girl

>attack killer
You slip the craft knife into your palm, scared to death, your limbs seem to move on their on volition. You slash at the killer's neck, blood gushes out. More blood than you ever saw.

press a key to continue...

>[enter]
(as Tad) You enter the Living room, the Demon is here. It is mocking you, calling out for your flesh. The parlour is due south, the kitchen to the east. Stairs go up to the second floor.

Living room
You don't care to notice anything in here, except the harbinger of death, the Demon. It mocks you, taunts you with ideas of pulling your flesh from your bones. You have to kill it.

You can see a Demon here.

Tad

* * *

>x demon
It has the figure of a man with leather-like skin, it has no use for clothes. The knees bend backwards, six razor talons extend where fingers would be. Sharp fangs fill the mouth, a bald head is adorned with two goat-like horns.

Tad

>kill demon
Another demon appears behind you, swiping at you with razor claws, and misses by a small miracle. You turn to face it, ready to cut it's throat. You realize your mistake the second you feel sharp claws slashing through your neck, and again, and again.

You crumple to the floor in a bloody mess, sobbing, bleeding out.

press a key to continue...

>[enter]
(as Otto) For a moment you stand lifeless, making sense of the scene. The Girl collapses to the floor. You have to get her out of here.

Living room
The room is dim and nothing you see makes sense. A door leads to the east, and some stairs go up to the second floor.

You can see The Girl and Tad here.

Otto

>up
That is not the way out.

Otto

>e
That is not the way out.

Otto

>s
You can't leave the girl lying here.

Otto

>take girl
You lift her up.

Otto

>s
You carry the girl outside, the cool night air promising peace. You hear sirens wailing over the hill.

    *** THE DAILY NEWS
Last night Victoria Cote was found safe in an abandoned house in an undisclosed location. Her family is relieved to have her back. Detective Otto York was first on the location to ensure her safety. The family and police declined to release further details at this time. ***

Would you like to RESTART, RESTORE a saved game, QUIT or UNDO the last command?